name_cn	
北京大学	
中国人民大学	人民大学
清华大学	
北京交通大学	交通大学
北京工业大学	工业大学
北京航空航天大学	航空航天大学
北京理工大学	理工大学
北京科技大学	科技大学
北方工业大学	工业大学
北京化工大学	化工大学
北京工商大学	工商大学
北京服装学院	服装学院
北京邮电大学	邮电大学
北京印刷学院	印刷学院
北京建筑大学	建筑大学
北京石油化工学院	石油化工学院
北京电子科技学院	电子科技学院
中国农业大学	农业大学
北京农学院	农学院
北京林业大学	林业大学
北京协和医学院	协和医学院
首都医科大学	医科大学
北京中医药大学	中医药大学
北京师范大学	师范大学
首都师范大学	师范大学
首都体育学院	体育学院
北京外国语大学	外国语大学
北京第二外国语学院	第二外国语学院
北京语言大学	语言大学
中国传媒大学	传媒大学
中央财经大学	财经大学
对外经济贸易大学	
北京物资学院	物资学院
首都经济贸易大学	经济贸易大学
外交学院	
中国人民公安大学	人民公安大学
国际关系学院	
北京体育大学	体育大学
中央音乐学院	音乐学院
中国音乐学院	音乐学院
中央美术学院	美术学院
中央戏剧学院	戏剧学院
中国戏曲学院	戏曲学院
北京电影学院	电影学院
北京舞蹈学院	舞蹈学院
中央民族大学	民族大学
中国政法大学	政法大学
华北电力大学	电力大学
中华女子学院	
北京信息科技大学	信息科技大学
中国石油大学	石油大学
北京联合大学	联合大学
北京城市学院	城市学院
中国青年政治学院	青年政治学院
首钢工学院	
中国劳动关系学院	劳动关系学院
北京吉利学院	吉利学院
北京警察学院	警察学院
中国科学院大学	科学院大学
北京工业职业技术学院	工业职业技术学院
北京信息职业技术学院	信息职业技术学院
北京电子科技职业学院	电子科技职业学院
北京京北职业技术学院	京北职业技术学院
北京交通职业技术学院	交通职业技术学院
北京青年政治学院	青年政治学院
北京农业职业学院	农业职业学院
北京政法职业学院	政法职业学院
北京财贸职业学院	财贸职业学院
北京北大方正软件职业技术学院	北大方正软件职业技术学院
北京经贸职业学院	经贸职业学院
北京经济技术职业学院	经济技术职业学院
北京戏曲艺术职业学院	戏曲艺术职业学院
北京汇佳职业学院	汇佳职业学院
北京科技经营管理学院	科技经营管理学院
北京科技职业学院	科技职业学院
北京培黎职业学院	培黎职业学院
北京经济管理职业学院	经济管理职业学院
北京劳动保障职业学院	劳动保障职业学院
北京社会管理职业学院	社会管理职业学院
北京艺术传媒职业学院	艺术传媒职业学院
北京体育职业学院	体育职业学院
北京交通运输职业学院	交通运输职业学院
北京卫生职业学院	卫生职业学院
北京市海淀区职工大学	海淀区职工大学
北京市东城区职工业余大学	东城区职工业余大学
北京市崇文区职工大学	崇文区职工大学
北京宣武红旗业余大学	宣武红旗业余大学
北京市石景山区业余大学	石景山区业余大学
北京市朝阳区职工大学	朝阳区职工大学
北京医药集团职工大学	医药集团职工大学
北京市建设职工大学	建设职工大学
北京市总工会职工大学	总工会职工大学
中央党校继续教育学院	党校继续教育学院
中国记协职工新闻学院	记协职工新闻学院
中南海业余大学	
北京教育学院	教育学院
北京开放大学	开放大学
国家开放大学	开放大学
民航管理干部学院	
北京市丰台区职工大学	丰台区职工大学
北京市西城经济科学大学	西城经济科学大学
北京市农工商联合总公司职工大学	农工商联合总公司职工大学
公安部管理干部学院	
国家法官学院	法官学院
华北电业联合职工大学	电业联合职工大学
首都联合职工大学	联合职工大学
国家检察官学院	检察官学院
首都师范大学科德学院	师范大学科德学院
北京工商大学嘉华学院	工商大学嘉华学院
北京邮电大学世纪学院	邮电大学世纪学院
北京工业大学耿丹学院	工业大学耿丹学院
北京第二外国语学院中瑞酒店管理学院	第二外国语学院中瑞酒店管理学院
南开大学	
天津大学	
天津科技大学	科技大学
天津工业大学	工业大学
中国民航大学	民航大学
天津理工大学	理工大学
天津农学院	农学院
天津医科大学	医科大学
天津中医药大学	中医药大学
天津师范大学	师范大学
天津职业技术师范大学	职业技术师范大学
天津外国语大学	外国语大学
天津商业大学	商业大学
天津财经大学	财经大学
天津体育学院	体育学院
天津音乐学院	音乐学院
天津美术学院	美术学院
天津城建大学	城建大学
天津天狮学院	天狮学院
天津市职业大学	职业大学
天津中德应用技术大学	中德应用技术大学
天津滨海职业学院	滨海职业学院
天津工程职业技术学院	工程职业技术学院
天津青年职业学院	青年职业学院
天津渤海职业技术学院	渤海职业技术学院
天津电子信息职业技术学院	电子信息职业技术学院
天津机电职业技术学院	机电职业技术学院
天津现代职业技术学院	现代职业技术学院
天津公安警官职业学院	公安警官职业学院
天津轻工职业技术学院	轻工职业技术学院
天津商务职业学院	商务职业学院
天津国土资源和房屋职业学院	国土资源和房屋职业学院
天津医学高等专科学校	医学高等专科学校
天津开发区职业技术学院	开发区职业技术学院
天津艺术职业学院	艺术职业学院
天津交通职业学院	交通职业学院
天津冶金职业技术学院	冶金职业技术学院
天津石油职业技术学院	石油职业技术学院
天津城市职业学院	城市职业学院
天津铁道职业技术学院	铁道职业技术学院
天津工艺美术职业学院	工艺美术职业学院
天津城市建设管理职业技术学院	城市建设管理职业技术学院
天津生物工程职业技术学院	生物工程职业技术学院
天津海运职业学院	海运职业学院
天津广播影视职业学院	广播影视职业学院
天津市和平区新华职工大学	和平区新华职工大学
天津市河西区职工大学	河西区职工大学
天津市河东区职工大学	河东区职工大学
天津市红桥区职工大学	红桥区职工大学
天津市南开区职工大学	南开区职工大学
天津市建筑工程职工大学	建筑工程职工大学
天津市职工经济技术大学	职工经济技术大学
天津市渤海化工职工学院	渤海化工职工学院
天津市管理干部学院	管理干部学院
天津市广播电视大学	广播电视大学
天津物资管理干部学院	物资管理干部学院
天津市政法管理干部学院	政法管理干部学院
天津市工会管理干部学院	工会管理干部学院
天津市房地产局职工大学	房地产局职工大学
南开大学滨海学院	
天津外国语大学滨海外事学院	外国语大学滨海外事学院
天津体育学院运动与文化艺术学院	体育学院运动与文化艺术学院
天津商业大学宝德学院	商业大学宝德学院
天津医科大学临床医学院	医科大学临床医学院
北京科技大学天津学院	科技大学天津学院
天津师范大学津沽学院	师范大学津沽学院
天津理工大学中环信息学院	理工大学中环信息学院
天津大学仁爱学院	大学仁爱学院
天津财经大学珠江学院	财经大学珠江学院
河北大学	
河北工程大学	工程大学
河北地质大学	地质大学
河北工业大学	工业大学
华北理工大学	理工大学
河北科技大学	科技大学
河北建筑工程学院	建筑工程学院
河北农业大学	农业大学
河北医科大学	医科大学
河北北方学院	北方学院
承德医学院	医学院
河北师范大学	师范大学
保定学院	
河北民族师范学院	民族师范学院
唐山师范学院	师范学院
廊坊师范学院	师范学院
衡水学院	
石家庄学院	
邯郸学院	
邢台学院	
沧州师范学院	师范学院
石家庄铁道大学	铁道大学
燕山大学	
河北科技师范学院	科技师范学院
唐山学院	
华北科技学院	科技学院
中国人民武装警察部队学院	人民武装警察部队学院
河北体育学院	体育学院
河北金融学院	金融学院
北华航天工业学院	
防灾科技学院	
河北经贸大学	经贸大学
中央司法警官学院	司法警官学院
河北传媒学院	传媒学院
河北工程技术学院	工程技术学院
河北美术学院	美术学院
河北科技学院	科技学院
河北外国语学院	外国语学院
燕京理工学院	
河北中医学院	中医学院
张家口学院	
河北水利电力学院	水利电力学院
河北工业职业技术学院	工业职业技术学院
邯郸职业技术学院	职业技术学院
石家庄职业技术学院	职业技术学院
张家口职业技术学院	职业技术学院
承德石油高等专科学校	石油高等专科学校
邢台职业技术学院	职业技术学院
河北软件职业技术学院	软件职业技术学院
河北石油职业技术学院	石油职业技术学院
河北建材职业技术学院	建材职业技术学院
河北政法职业学院	政法职业学院
沧州职业技术学院	职业技术学院
河北能源职业技术学院	能源职业技术学院
石家庄铁路职业技术学院	铁路职业技术学院
保定职业技术学院	职业技术学院
秦皇岛职业技术学院	职业技术学院
石家庄工程职业学院	工程职业学院
石家庄城市经济职业学院	城市经济职业学院
唐山职业技术学院	职业技术学院
衡水职业技术学院	职业技术学院
唐山工业职业技术学院	工业职业技术学院
邢台医学高等专科学校	医学高等专科学校
河北省艺术职业学院	艺术职业学院
河北旅游职业学院	旅游职业学院
石家庄财经职业学院	财经职业学院
河北交通职业技术学院	交通职业技术学院
河北化工医药职业技术学院	化工医药职业技术学院
石家庄信息工程职业学院	信息工程职业学院
河北对外经贸职业学院	对外经贸职业学院
保定电力职业技术学院	电力职业技术学院
河北机电职业技术学院	机电职业技术学院
渤海石油职业学院	
廊坊职业技术学院	职业技术学院
唐山科技职业技术学院	科技职业技术学院
石家庄邮电职业技术学院	邮电职业技术学院
河北公安警察职业学院	公安警察职业学院
石家庄工商职业学院	工商职业学院
石家庄理工职业学院	理工职业学院
石家庄科技信息职业学院	科技信息职业学院
河北司法警官职业学院	司法警官职业学院
沧州医学高等专科学校	医学高等专科学校
河北女子职业技术学院	女子职业技术学院
石家庄医学高等专科学校	医学高等专科学校
石家庄经济职业学院	经济职业学院
冀中职业学院	
石家庄人民医学高等专科学校	人民医学高等专科学校
石家庄科技工程职业学院	科技工程职业学院
河北劳动关系职业学院	劳动关系职业学院
石家庄科技职业学院	科技职业学院
河北东方学院	东方学院
泊头职业学院	
宣化科技职业学院	
廊坊燕京职业技术学院	燕京职业技术学院
承德护理职业学院	护理职业学院
石家庄幼儿师范高等专科学校	幼儿师范高等专科学校
廊坊卫生职业学院	卫生职业学院
河北轨道运输职业技术学院	轨道运输职业技术学院
保定幼儿师范高等专科学校	幼儿师范高等专科学校
河北工艺美术职业学院	工艺美术职业学院
渤海理工职业学院	
河北地质职工大学	地质职工大学
河北省广播电视大学	广播电视大学
石家庄职工大学	职工大学
河北环境工程学院	环境工程学院
河北管理干部学院	管理干部学院
河北青年管理干部学院	青年管理干部学院
华北理工大学轻工学院	理工大学轻工学院
河北工程大学科信学院	工程大学科信学院
华北电力大学科技学院	电力大学科技学院
河北科技大学理工学院	科技大学理工学院
河北大学工商学院	大学工商学院
河北师范大学汇华学院	师范大学汇华学院
河北医科大学临床学院	医科大学临床学院
河北经贸大学经济管理学院	经贸大学经济管理学院
河北工业大学城市学院	工业大学城市学院
燕山大学里仁学院	
石家庄铁道大学四方学院	铁道大学四方学院
河北地质大学华信学院	地质大学华信学院
河北农业大学现代科技学院	农业大学现代科技学院
华北理工大学冀唐学院	理工大学冀唐学院
中国地质大学长城学院	地质大学长城学院
北京中医药大学东方学院	中医药大学东方学院
北京交通大学海滨学院	交通大学海滨学院
山西大学	
太原科技大学	科技大学
中北大学	
太原理工大学	理工大学
山西农业大学	农业大学
山西医科大学	医科大学
长治医学院	医学院
山西师范大学	师范大学
太原师范学院	师范学院
山西大同大学	大同大学
晋中学院	
长治学院	
运城学院	
忻州师范学院	师范学院
山西财经大学	财经大学
山西中医学院	中医学院
吕梁学院	
太原学院	
山西应用科技学院	应用科技学院
山西工商学院	工商学院
太原工业学院	工业学院
山西传媒学院	传媒学院
山西工程技术学院	工程技术学院
山西省财政税务专科学校	财政税务专科学校
山西警察学院	警察学院
长治职业技术学院	职业技术学院
山西艺术职业学院	艺术职业学院
晋城职业技术学院	职业技术学院
山西建筑职业技术学院	建筑职业技术学院
山西药科职业学院	药科职业学院
山西工程职业技术学院	工程职业技术学院
山西交通职业技术学院	交通职业技术学院
大同煤炭职业技术学院	煤炭职业技术学院
山西机电职业技术学院	机电职业技术学院
山西戏剧职业学院	戏剧职业学院
山西财贸职业技术学院	财贸职业技术学院
山西林业职业技术学院	林业职业技术学院
山西水利职业技术学院	水利职业技术学院
阳泉职业技术学院	职业技术学院
临汾职业技术学院	职业技术学院
山西职业技术学院	职业技术学院
山西煤炭职业技术学院	煤炭职业技术学院
山西金融职业学院	金融职业学院
太原城市职业技术学院	城市职业技术学院
山西信息职业技术学院	信息职业技术学院
山西体育职业学院	体育职业学院
山西警官职业学院	警官职业学院
山西国际商务职业学院	国际商务职业学院
潞安职业技术学院	
太原旅游职业学院	旅游职业学院
山西旅游职业学院	旅游职业学院
山西管理职业学院	管理职业学院
山西电力职业技术学院	电力职业技术学院
忻州职业技术学院	职业技术学院
山西同文职业技术学院	同文职业技术学院
晋中职业技术学院	职业技术学院
山西华澳商贸职业学院	华澳商贸职业学院
山西运城农业职业技术学院	运城农业职业技术学院
运城幼儿师范高等专科学校	幼儿师范高等专科学校
山西老区职业技术学院	老区职业技术学院
山西经贸职业学院	经贸职业学院
朔州职业技术学院	职业技术学院
运城职业技术学院	职业技术学院
山西轻工职业技术学院	轻工职业技术学院
晋中师范高等专科学校	师范高等专科学校
阳泉师范高等专科学校	师范高等专科学校
山西青年职业学院	青年职业学院
运城护理职业学院	护理职业学院
运城师范高等专科学校	师范高等专科学校
朔州师范高等专科学校	师范高等专科学校
吕梁职业技术学院	职业技术学院
太原化学工业集团有限公司职工大学	化学工业集团有限公司职工大学
山西机电职工学院	机电职工学院
太原钢铁(集团)有限公司职工钢铁学院	钢铁(集团)有限公司职工钢铁学院
山西职工医学院	职工医学院
山西煤炭职工联合大学	煤炭职工联合大学
山西兵器工业职工大学	兵器工业职工大学
山西省职工工艺美术学院	职工工艺美术学院
山西省吕梁市教育学院	吕梁市教育学院
山西省广播电视大学	广播电视大学
山西能源学院	能源学院
山西省政法管理干部学院	政法管理干部学院
长治市教育学院	教育学院
山西大学商务学院	大学商务学院
太原理工大学现代科技学院	理工大学现代科技学院
山西农业大学信息学院	农业大学信息学院
山西师范大学现代文理学院	师范大学现代文理学院
中北大学信息商务学院	
太原科技大学华科学院	科技大学华科学院
山西医科大学晋祠学院	医科大学晋祠学院
山西财经大学华商学院	财经大学华商学院
内蒙古大学	
内蒙古科技大学	科技大学
内蒙古工业大学	工业大学
内蒙古农业大学	农业大学
内蒙古医科大学	医科大学
内蒙古师范大学	师范大学
内蒙古民族大学	民族大学
赤峰学院	
内蒙古财经大学	财经大学
呼伦贝尔学院	
集宁师范学院	
河套学院	
呼和浩特民族学院	民族学院
内蒙古建筑职业技术学院	建筑职业技术学院
内蒙古丰州职业学院	丰州职业学院
包头职业技术学院	职业技术学院
兴安职业技术学院	
呼和浩特职业学院	职业学院
包头轻工职业技术学院	轻工职业技术学院
内蒙古电子信息职业技术学院	电子信息职业技术学院
内蒙古机电职业技术学院	机电职业技术学院
内蒙古化工职业学院	化工职业学院
内蒙古商贸职业学院	商贸职业学院
锡林郭勒职业学院	
内蒙古警察职业学院	警察职业学院
内蒙古体育职业学院	体育职业学院
乌兰察布职业学院	职业学院
通辽职业学院	职业学院
科尔沁艺术职业学院	
内蒙古交通职业技术学院	交通职业技术学院
包头钢铁职业技术学院	钢铁职业技术学院
乌海职业技术学院	职业技术学院
内蒙古科技职业学院	科技职业学院
内蒙古北方职业技术学院	北方职业技术学院
赤峰职业技术学院	职业技术学院
内蒙古经贸外语职业学院	经贸外语职业学院
包头铁道职业技术学院	铁道职业技术学院
乌兰察布医学高等专科学校	医学高等专科学校
鄂尔多斯职业学院	职业学院
内蒙古工业职业学院	工业职业学院
呼伦贝尔职业技术学院	职业技术学院
满洲里俄语职业学院	
内蒙古能源职业学院	能源职业学院
赤峰工业职业技术学院	工业职业技术学院
阿拉善职业技术学院	
内蒙古美术职业学院	美术职业学院
内蒙古民族幼儿师范高等专科学校	民族幼儿师范高等专科学校
鄂尔多斯生态环境职业学院	生态环境职业学院
包头市职工大学	职工大学
内蒙古自治区广播电视大学	自治区广播电视大学
内蒙古大学创业学院	大学创业学院
内蒙古师范大学鸿德学院	师范大学鸿德学院
大连理工大学	理工大学
辽宁大学	
沈阳工业大学	工业大学
沈阳航空航天大学	航空航天大学
沈阳理工大学	理工大学
东北大学	
辽宁科技大学	科技大学
辽宁工程技术大学	工程技术大学
辽宁石油化工大学	石油化工大学
沈阳化工大学	化工大学
大连交通大学	交通大学
大连海事大学	海事大学
大连工业大学	工业大学
沈阳建筑大学	建筑大学
辽宁工业大学	工业大学
沈阳农业大学	农业大学
大连海洋大学	海洋大学
中国医科大学	医科大学
锦州医科大学	医科大学
大连医科大学	医科大学
辽宁中医药大学	中医药大学
沈阳药科大学	药科大学
沈阳医学院	医学院
辽宁师范大学	师范大学
沈阳师范大学	师范大学
渤海大学	
鞍山师范学院	师范学院
大连外国语大学	外国语大学
东北财经大学	财经大学
中国刑事警察学院	刑事警察学院
沈阳体育学院	体育学院
沈阳音乐学院	音乐学院
鲁迅美术学院	
辽宁对外经贸学院	对外经贸学院
沈阳大学	
大连大学	
辽宁科技学院	科技学院
辽宁警察学院	警察学院
沈阳工程学院	工程学院
辽东学院	
大连民族大学	民族大学
沈阳工学院	工学院
大连科技学院	科技学院
沈阳城市建设学院	城市建设学院
辽宁理工学院	理工学院
大连财经学院	财经学院
沈阳城市学院	城市学院
大连艺术学院	艺术学院
辽宁何氏医学院	何氏医学院
大连东软信息学院	东软信息学院
辽宁财贸学院	财贸学院
辽宁传媒学院	传媒学院
营口理工学院	理工学院
朝阳师范高等专科学校	师范高等专科学校
抚顺师范高等专科学校	师范高等专科学校
锦州师范高等专科学校	师范高等专科学校
营口职业技术学院	职业技术学院
铁岭师范高等专科学校	师范高等专科学校
大连职业技术学院	职业技术学院
辽宁农业职业技术学院	农业职业技术学院
抚顺职业技术学院	职业技术学院
辽阳职业技术学院	职业技术学院
阜新高等专科学校	高等专科学校
辽宁省交通高等专科学校	交通高等专科学校
辽宁税务高等专科学校	税务高等专科学校
盘锦职业技术学院	职业技术学院
沈阳航空职业技术学院	航空职业技术学院
辽宁体育运动职业技术学院	体育运动职业技术学院
辽宁职业学院	职业学院
辽宁林业职业技术学院	林业职业技术学院
沈阳职业技术学院	职业技术学院
辽宁理工职业学院	理工职业学院
大连商务职业学院	商务职业学院
辽宁金融职业学院	金融职业学院
辽宁轨道交通职业学院	轨道交通职业学院
辽宁广告职业学院	广告职业学院
辽宁机电职业技术学院	机电职业技术学院
辽宁经济职业技术学院	经济职业技术学院
辽宁石化职业技术学院	石化职业技术学院
渤海船舶职业学院	
大连软件职业学院	软件职业学院
大连翻译职业学院	翻译职业学院
辽宁商贸职业学院	商贸职业学院
大连枫叶职业技术学院	枫叶职业技术学院
辽宁装备制造职业技术学院	装备制造职业技术学院
辽河石油职业技术学院	
辽宁地质工程职业学院	地质工程职业学院
辽宁铁道职业技术学院	铁道职业技术学院
辽宁建筑职业学院	建筑职业学院
大连航运职业技术学院	航运职业技术学院
大连装备制造职业技术学院	装备制造职业技术学院
大连汽车职业技术学院	汽车职业技术学院
辽宁现代服务职业技术学院	现代服务职业技术学院
辽宁冶金职业技术学院	冶金职业技术学院
辽宁工程职业学院	工程职业学院
辽宁城市建设职业技术学院	城市建设职业技术学院
辽宁医药职业学院	医药职业学院
铁岭卫生职业学院	卫生职业学院
沈阳北软信息职业技术学院	北软信息职业技术学院
辽宁政法职业学院	政法职业学院
辽宁民族师范高等专科学校	民族师范高等专科学校
辽宁轻工职业学院	轻工职业学院
辽宁水利职业学院	水利职业学院
辽宁特殊教育师范高等专科学校	特殊教育师范高等专科学校
辽宁兵器工业职工大学	兵器工业职工大学
辽宁省直属机关职工大学	直属机关职工大学
大连工人大学	工人大学
空军第四职工大学	
海军职工大学	
大连职工大学	职工大学
抚顺矿务局职工工学院	矿务局职工工学院
抚顺石油化工公司职工大学	石油化工公司职工大学
阜新矿务局职工大学	矿务局职工大学
朝阳职工工学院	职工工学院
大连市教育学院	教育学院
辽宁广播电视大学	广播电视大学
阜新煤炭职工医学专科学校	煤炭职工医学专科学校
辽宁文化艺术职工大学	文化艺术职工大学
辽宁冶金职工大学	冶金职工大学
辽宁公安司法管理干部学院	公安司法管理干部学院
沈阳机械工业职工大学	机械工业职工大学
鞍山钢铁集团公司职工大学	钢铁集团公司职工大学
沈阳市广播电视大学	广播电视大学
大连市广播电视大学	广播电视大学
大连理工大学城市学院	理工大学城市学院
沈阳航空航天大学北方科技学院	航空航天大学北方科技学院
大连工业大学艺术与信息工程学院	工业大学艺术与信息工程学院
辽宁科技大学信息技术学院	科技大学信息技术学院
中国医科大学临床医药学院	医科大学临床医药学院
辽宁石油化工大学顺华能源学院	石油化工大学顺华能源学院
辽宁师范大学海华学院	师范大学海华学院
辽宁中医药大学杏林学院	中医药大学杏林学院
锦州医科大学医疗学院	医科大学医疗学院
大连医科大学中山学院	医科大学中山学院
沈阳工业大学工程学院	工业大学工程学院
沈阳科技学院	科技学院
吉林大学	
延边大学	
长春理工大学	理工大学
东北电力大学	电力大学
长春工业大学	工业大学
吉林建筑大学	建筑大学
吉林化工学院	化工学院
吉林农业大学	农业大学
长春中医药大学	中医药大学
东北师范大学	师范大学
北华大学	
通化师范学院	师范学院
吉林师范大学	师范大学
吉林工程技术师范学院	工程技术师范学院
长春师范大学	师范大学
白城师范学院	师范学院
吉林财经大学	财经大学
吉林体育学院	体育学院
吉林艺术学院	艺术学院
吉林华桥外国语学院	华桥外国语学院
吉林工商学院	工商学院
长春工程学院	工程学院
吉林农业科技学院	农业科技学院
吉林警察学院	警察学院
长春大学	
长春光华学院	光华学院
长春财经学院	财经学院
长春建筑学院	建筑学院
长春科技学院	科技学院
吉林动画学院	动画学院
吉林医药学院	医药学院
辽源职业技术学院	职业技术学院
四平职业大学	职业大学
长春汽车工业高等专科学校	汽车工业高等专科学校
长春金融高等专科学校	金融高等专科学校
长春医学高等专科学校	医学高等专科学校
吉林交通职业技术学院	交通职业技术学院
长春东方职业学院	东方职业学院
吉林司法警官职业学院	司法警官职业学院
吉林电子信息职业技术学院	电子信息职业技术学院
吉林工业职业技术学院	工业职业技术学院
吉林工程职业学院	工程职业学院
长春职业技术学院	职业技术学院
白城医学高等专科学校	医学高等专科学校
长春信息技术职业学院	信息技术职业学院
松原职业技术学院	职业技术学院
吉林铁道职业技术学院	铁道职业技术学院
白城职业技术学院	职业技术学院
长白山职业技术学院	
吉林科技职业技术学院	科技职业技术学院
延边职业技术学院	职业技术学院
吉林城市职业技术学院	城市职业技术学院
长春职工大学	职工大学
长春市建筑职工业余大学	建筑职工业余大学
长春职工医科大学	职工医科大学
吉林市职工大学	职工大学
吉林化学工业公司职工大学	化学工业公司职工大学
通化市职工大学	职工大学
通化钢铁公司职工大学	钢铁公司职工大学
四平农村成人高等专科学校	农村成人高等专科学校
吉林省教育学院	教育学院
长春教育学院	教育学院
吉林广播电视大学	广播电视大学
吉林省经济管理干部学院	经济管理干部学院
吉林职工医科大学	职工医科大学
长春广播电视大学	广播电视大学
吉林建筑大学城建学院	建筑大学城建学院
长春工业大学人文信息学院	工业大学人文信息学院
长春理工大学光电信息学院	理工大学光电信息学院
东北师范大学人文学院	师范大学人文学院
吉林师范大学博达学院	师范大学博达学院
长春大学旅游学院	大学旅游学院
黑龙江大学	
哈尔滨工业大学	工业大学
哈尔滨理工大学	理工大学
哈尔滨工程大学	工程大学
黑龙江科技大学	科技大学
东北石油大学	石油大学
佳木斯大学	
黑龙江八一农垦大学	八一农垦大学
东北农业大学	农业大学
东北林业大学	林业大学
哈尔滨医科大学	医科大学
黑龙江中医药大学	中医药大学
牡丹江医学院	医学院
哈尔滨师范大学	师范大学
齐齐哈尔大学	
牡丹江师范学院	师范学院
哈尔滨学院	
大庆师范学院	师范学院
绥化学院	
哈尔滨商业大学	商业大学
哈尔滨体育学院	体育学院
哈尔滨金融学院	金融学院
齐齐哈尔医学院	医学院
黑龙江工业学院	工业学院
黑龙江东方学院	东方学院
哈尔滨信息工程学院	信息工程学院
黑龙江工程学院	工程学院
齐齐哈尔工程学院	工程学院
黑龙江外国语学院	外国语学院
黑龙江财经学院	财经学院
哈尔滨石油学院	石油学院
哈尔滨远东理工学院	远东理工学院
哈尔滨剑桥学院	剑桥学院
哈尔滨广厦学院	广厦学院
哈尔滨华德学院	华德学院
黑河学院	
齐齐哈尔高等师范专科学校	高等师范专科学校
伊春职业学院	职业学院
牡丹江大学	
黑龙江职业学院	职业学院
黑龙江建筑职业技术学院	建筑职业技术学院
黑龙江艺术职业学院	艺术职业学院
大庆职业学院	职业学院
黑龙江林业职业技术学院	林业职业技术学院
黑龙江农业职业技术学院	农业职业技术学院
黑龙江农业工程职业学院	农业工程职业学院
黑龙江农垦职业学院	农垦职业学院
黑龙江司法警官职业学院	司法警官职业学院
鹤岗师范高等专科学校	师范高等专科学校
哈尔滨电力职业技术学院	电力职业技术学院
哈尔滨铁道职业技术学院	铁道职业技术学院
大兴安岭职业学院	职业学院
黑龙江农业经济职业学院	农业经济职业学院
哈尔滨职业技术学院	职业技术学院
哈尔滨传媒职业学院	传媒职业学院
黑龙江生物科技职业学院	生物科技职业学院
黑龙江商业职业学院	商业职业学院
黑龙江公安警官职业学院	公安警官职业学院
黑龙江信息技术职业学院	信息技术职业学院
哈尔滨江南职业技术学院	江南职业技术学院
黑龙江农垦科技职业学院	农垦科技职业学院
黑龙江旅游职业技术学院	旅游职业技术学院
黑龙江三江美术职业学院	三江美术职业学院
黑龙江生态工程职业学院	生态工程职业学院
黑龙江煤炭职业技术学院	煤炭职业技术学院
七台河职业学院	职业学院
黑龙江民族职业学院	民族职业学院
大庆医学高等专科学校	医学高等专科学校
黑龙江交通职业技术学院	交通职业技术学院
哈尔滨应用职业技术学院	应用职业技术学院
黑龙江幼儿师范高等专科学校	幼儿师范高等专科学校
哈尔滨科学技术职业学院	科学技术职业学院
黑龙江粮食职业学院	粮食职业学院
佳木斯职业学院	职业学院
黑龙江护理高等专科学校	护理高等专科学校
哈尔滨工程技术职业学院	工程技术职业学院
齐齐哈尔理工职业学院	理工职业学院
哈尔滨幼儿师范高等专科学校	幼儿师范高等专科学校
黑龙江兵器工业职工大学	兵器工业职工大学
哈尔滨航空职工大学	航空职工大学
哈尔滨轻型车厂职工大学	轻型车厂职工大学
哈尔滨市职工大学	职工大学
黑龙江省电力职工大学	电力职工大学
齐齐哈尔市建设职工大学	建设职工大学
齐齐哈尔市职工大学	职工大学
鹤岗矿务局职工大学	矿务局职工大学
大庆石油化工总厂职工大学	石油化工总厂职工大学
黑龙江农垦管理干部学院	农垦管理干部学院
黑龙江省经济管理干部学院	经济管理干部学院
黑龙江省政法管理干部学院	政法管理干部学院
黑龙江省教育学院	教育学院
绥化市教育学院	教育学院
牡丹江市教育学院	教育学院
佳木斯市教育学院	教育学院
黑龙江省广播电视大学	广播电视大学
黑龙江省商业职工大学	商业职工大学
黑龙江省社会科学院职工大学	社会科学院职工大学
哈尔滨市职工医学院	职工医学院
黑龙江省职工体育运动技术学院	职工体育运动技术学院
哈尔滨市广播电视大学	广播电视大学
黑龙江工商学院	工商学院
黑龙江工程学院昆仑旅游学院	工程学院昆仑旅游学院
复旦大学	
同济大学	
上海交通大学	交通大学
华东理工大学	理工大学
上海理工大学	理工大学
上海海事大学	海事大学
东华大学	
上海电力学院	电力学院
上海应用技术大学	应用技术大学
上海海洋大学	海洋大学
上海中医药大学	中医药大学
华东师范大学	师范大学
上海师范大学	师范大学
上海外国语大学	外国语大学
上海财经大学	财经大学
上海对外经贸大学	对外经贸大学
上海海关学院	海关学院
华东政法大学	政法大学
上海体育学院	体育学院
上海音乐学院	音乐学院
上海戏剧学院	戏剧学院
上海大学	
上海工程技术大学	工程技术大学
上海立信会计金融学院	立信会计金融学院
上海电机学院	电机学院
上海杉达学院	杉达学院
上海政法学院	政法学院
上海第二工业大学	第二工业大学
上海商学院	商学院
上海建桥学院	建桥学院
上海兴伟学院	兴伟学院
上海视觉艺术学院	视觉艺术学院
上海科技大学	科技大学
上海纽约大学	纽约大学
上海旅游高等专科学校	旅游高等专科学校
上海公安学院	公安学院
上海东海职业技术学院	东海职业技术学院
上海工商职业技术学院	工商职业技术学院
上海出版印刷高等专科学校	出版印刷高等专科学校
上海行健职业学院	行健职业学院
上海城建职业学院	城建职业学院
上海交通职业技术学院	交通职业技术学院
上海海事职业技术学院	海事职业技术学院
上海电子信息职业技术学院	电子信息职业技术学院
上海震旦职业学院	震旦职业学院
上海民远职业技术学院	民远职业技术学院
上海欧华职业技术学院	欧华职业技术学院
上海思博职业技术学院	思博职业技术学院
上海立达职业技术学院	立达职业技术学院
上海工艺美术职业学院	工艺美术职业学院
上海济光职业技术学院	济光职业技术学院
上海工商外国语职业学院	工商外国语职业学院
上海科学技术职业学院	科学技术职业学院
上海农林职业技术学院	农林职业技术学院
上海邦德职业技术学院	邦德职业技术学院
上海中侨职业技术学院	中侨职业技术学院
上海电影艺术职业学院	电影艺术职业学院
上海中华职业技术学院	中华职业技术学院
上海体育职业学院	体育职业学院
上海健康医学院	健康医学院
上海民航职业技术学院	民航职业技术学院
上海科技管理干部学院	科技管理干部学院
上海市黄浦区业余大学	黄浦区业余大学
上海市徐汇区业余大学	徐汇区业余大学
上海市长宁区业余大学	长宁区业余大学
上海市静安区业余大学	静安区业余大学
上海市普陀区业余大学	普陀区业余大学
上海市虹口区业余大学	虹口区业余大学
上海市杨浦区业余大学	杨浦区业余大学
上海纺织工业职工大学	纺织工业职工大学
上海医药职工大学	医药职工大学
上海开放大学	开放大学
海关管理干部学院	
上海市经济管理干部学院	经济管理干部学院
上海青年管理干部学院	青年管理干部学院
上海市宝山区业余大学	宝山区业余大学
上海外国语大学贤达经济人文学院	外国语大学贤达经济人文学院
上海师范大学天华学院	师范大学天华学院
南京大学	
苏州大学	
东南大学	
南京航空航天大学	航空航天大学
南京理工大学	理工大学
江苏科技大学	科技大学
中国矿业大学	矿业大学
南京工业大学	工业大学
常州大学	
南京邮电大学	邮电大学
河海大学	
江南大学	
南京林业大学	林业大学
江苏大学	
南京信息工程大学	信息工程大学
南通大学	
盐城工学院	工学院
南京农业大学	农业大学
南京医科大学	医科大学
徐州医科大学	医科大学
南京中医药大学	中医药大学
中国药科大学	药科大学
南京师范大学	师范大学
江苏师范大学	师范大学
淮阴师范学院	
盐城师范学院	师范学院
南京财经大学	财经大学
江苏警官学院	警官学院
南京体育学院	体育学院
南京艺术学院	艺术学院
苏州科技大学	科技大学
常熟理工学院	
淮阴工学院	
常州工学院	工学院
扬州大学	
三江学院	
南京工程学院	工程学院
南京审计大学	审计大学
南京晓庄学院	晓庄学院
江苏理工学院	理工学院
淮海工学院	
徐州工程学院	工程学院
南通理工学院	理工学院
南京森林警察学院	森林警察学院
泰州学院	
无锡太湖学院	太湖学院
金陵科技学院	
宿迁学院	
江苏第二师范学院	第二师范学院
西交利物浦大学	
昆山杜克大学	
民办明达职业技术学院	
无锡职业技术学院	职业技术学院
江苏建筑职业技术学院	建筑职业技术学院
南京工业职业技术学院	工业职业技术学院
江苏工程职业技术学院	工程职业技术学院
苏州工艺美术职业技术学院	工艺美术职业技术学院
连云港职业技术学院	职业技术学院
镇江市高等专科学校	高等专科学校
南通职业大学	职业大学
苏州职业大学	职业大学
沙洲职业工学院	
扬州市职业大学	职业大学
连云港师范高等专科学校	师范高等专科学校
江苏经贸职业技术学院	经贸职业技术学院
南京特殊教育师范学院	特殊教育师范学院
九州职业技术学院	
硅湖职业技术学院	
泰州职业技术学院	职业技术学院
常州信息职业技术学院	信息职业技术学院
江苏联合职业技术学院	联合职业技术学院
江苏海事职业技术学院	海事职业技术学院
应天职业技术学院	
无锡科技职业学院	科技职业学院
盐城卫生职业技术学院	卫生职业技术学院
扬州环境资源职业技术学院	环境资源职业技术学院
南通科技职业学院	科技职业学院
苏州经贸职业技术学院	经贸职业技术学院
苏州工业职业技术学院	工业职业技术学院
苏州托普信息职业技术学院	托普信息职业技术学院
苏州卫生职业技术学院	卫生职业技术学院
无锡商业职业技术学院	商业职业技术学院
南通航运职业技术学院	航运职业技术学院
南京交通职业技术学院	交通职业技术学院
淮安信息职业技术学院	信息职业技术学院
江苏农牧科技职业学院	农牧科技职业学院
常州纺织服装职业技术学院	纺织服装职业技术学院
苏州农业职业技术学院	农业职业技术学院
苏州工业园区职业技术学院	工业园区职业技术学院
太湖创意职业技术学院	
炎黄职业技术学院	
南京科技职业学院	科技职业学院
正德职业技术学院	
钟山职业技术学院	
无锡南洋职业技术学院	南洋职业技术学院
江南影视艺术职业学院	
金肯职业技术学院	
常州轻工职业技术学院	轻工职业技术学院
常州工程职业技术学院	工程职业技术学院
江苏农林职业技术学院	农林职业技术学院
江苏食品药品职业技术学院	食品药品职业技术学院
建东职业技术学院	
南京铁道职业技术学院	铁道职业技术学院
徐州工业职业技术学院	工业职业技术学院
江苏信息职业技术学院	信息职业技术学院
宿迁职业技术学院	职业技术学院
南京信息职业技术学院	信息职业技术学院
江海职业技术学院	
常州机电职业技术学院	机电职业技术学院
江阴职业技术学院	
无锡城市职业技术学院	城市职业技术学院
无锡工艺职业技术学院	工艺职业技术学院
金山职业技术学院	
苏州健雄职业技术学院	健雄职业技术学院
盐城工业职业技术学院	工业职业技术学院
江苏财经职业技术学院	财经职业技术学院
扬州工业职业技术学院	工业职业技术学院
苏州港大思培科技职业学院	港大思培科技职业学院
昆山登云科技职业学院	
南京视觉艺术职业学院	视觉艺术职业学院
江苏城市职业学院	城市职业学院
南京城市职业学院	城市职业学院
南京机电职业技术学院	机电职业技术学院
苏州高博软件技术职业学院	高博软件技术职业学院
南京旅游职业学院	旅游职业学院
江苏建康职业学院	建康职业学院
苏州信息职业技术学院	信息职业技术学院
宿迁泽达职业技术学院	泽达职业技术学院
苏州工业园区服务外包职业学院	工业园区服务外包职业学院
徐州幼儿师范高等专科学校	幼儿师范高等专科学校
徐州生物工程职业技术学院	生物工程职业技术学院
江苏商贸职业学院	商贸职业学院
南通师范高等专科学校	师范高等专科学校
扬州中瑞酒店职业学院	中瑞酒店职业学院
南京市职工大学	职工大学
空军第一职工大学	
常州市职工大学	职工大学
南通市工人业余大学	工人业余大学
扬州教育学院	教育学院
江苏开放大学	开放大学
江苏省省级机关管理干部学院	省级机关管理干部学院
南京市广播电视大学	广播电视大学
江苏省青年管理干部学院	青年管理干部学院
东南大学成贤学院	大学成贤学院
中国矿业大学徐海学院	矿业大学徐海学院
南京大学金陵学院	大学金陵学院
南京理工大学紫金学院	理工大学紫金学院
南京航空航天大学金城学院	航空航天大学金城学院
中国传媒大学南广学院	传媒大学南广学院
南京理工大学泰州科技学院	理工大学泰州科技学院
南京师范大学泰州学院	师范大学泰州学院
南京工业大学浦江学院	工业大学浦江学院
南京师范大学中北学院	师范大学中北学院
南京医科大学康达学院	医科大学康达学院
南京中医药大学翰林学院	中医药大学翰林学院
南京信息工程大学滨江学院	信息工程大学滨江学院
苏州大学文正学院	大学文正学院
苏州大学应用技术学院	大学应用技术学院
苏州科技大学天平学院	科技大学天平学院
江苏大学京江学院	大学京江学院
扬州大学广陵学院	大学广陵学院
江苏师范大学科文学院	师范大学科文学院
南京邮电大学通达学院	邮电大学通达学院
南京财经大学红山学院	财经大学红山学院
江苏科技大学苏州理工学院	科技大学苏州理工学院
常州大学怀德学院	大学怀德学院
南通大学杏林学院	大学杏林学院
南京审计大学金审学院	审计大学金审学院
浙江大学	
杭州电子科技大学	电子科技大学
浙江工业大学	工业大学
浙江理工大学	理工大学
浙江海洋大学	海洋大学
浙江农林大学	农林大学
温州医科大学	医科大学
浙江中医药大学	中医药大学
浙江师范大学	师范大学
杭州师范大学	师范大学
湖州师范学院	师范学院
绍兴文理学院	文理学院
台州学院	
温州大学	
丽水学院	
浙江工商大学	工商大学
嘉兴学院	
中国美术学院	美术学院
中国计量大学	计量大学
公安海警学院	
浙江万里学院	万里学院
浙江科技学院	科技学院
宁波工程学院	工程学院
浙江水利水电学院	水利水电学院
浙江财经大学	财经大学
浙江警察学院	警察学院
衢州学院	
宁波大学	
浙江传媒学院	传媒学院
浙江树人学院	树人学院
浙江越秀外国语学院	越秀外国语学院
宁波大红鹰学院	大红鹰学院
浙江外国语学院	外国语学院
宁波诺丁汉大学	诺丁汉大学
温州肯恩大学	肯恩大学
宁波职业技术学院	职业技术学院
温州职业技术学院	职业技术学院
浙江交通职业技术学院	交通职业技术学院
金华职业技术学院	职业技术学院
宁波城市职业技术学院	城市职业技术学院
浙江电力职业技术学院	电力职业技术学院
浙江同济科技职业学院	同济科技职业学院
浙江工商职业技术学院	工商职业技术学院
台州职业技术学院	职业技术学院
浙江工贸职业技术学院	工贸职业技术学院
浙江医药高等专科学校	医药高等专科学校
浙江机电职业技术学院	机电职业技术学院
浙江建设职业技术学院	建设职业技术学院
浙江艺术职业学院	艺术职业学院
浙江经贸职业技术学院	经贸职业技术学院
浙江商业职业技术学院	商业职业技术学院
浙江经济职业技术学院	经济职业技术学院
浙江旅游职业学院	旅游职业学院
浙江育英职业技术学院	育英职业技术学院
浙江警官职业学院	警官职业学院
浙江金融职业学院	金融职业学院
浙江工业职业技术学院	工业职业技术学院
杭州职业技术学院	职业技术学院
嘉兴职业技术学院	职业技术学院
湖州职业技术学院	职业技术学院
绍兴职业技术学院	职业技术学院
衢州职业技术学院	职业技术学院
丽水职业技术学院	职业技术学院
浙江东方职业技术学院	东方职业技术学院
义乌工商职业技术学院	
杭州医学院	医学院
浙江纺织服装职业技术学院	纺织服装职业技术学院
杭州科技职业技术学院	科技职业技术学院
浙江长征职业技术学院	长征职业技术学院
嘉兴南洋职业技术学院	南洋职业技术学院
浙江广厦建设职业技术学院	广厦建设职业技术学院
杭州万向职业技术学院	万向职业技术学院
浙江邮电职业技术学院	邮电职业技术学院
宁波卫生职业技术学院	卫生职业技术学院
台州科技职业学院	科技职业学院
浙江国际海运职业技术学院	国际海运职业技术学院
浙江体育职业技术学院	体育职业技术学院
温州科技职业学院	科技职业学院
浙江汽车职业技术学院	汽车职业技术学院
浙江横店影视职业学院	横店影视职业学院
浙江农业商贸职业学院	农业商贸职业学院
浙江特殊教育职业学院	特殊教育职业学院
浙江省省级机关职工业余大学	省级机关职工业余大学
杭州市工人业余大学	工人业余大学
温州市工人业余大学	工人业余大学
宁波教育学院	教育学院
金华教育学院	教育学院
浙江省广播电视大学	广播电视大学
浙江经济管理职工大学	经济管理职工大学
浙江嘉兴教育学院	嘉兴教育学院
宁波市广播电视大学	广播电视大学
浙江大学城市学院	大学城市学院
浙江大学宁波理工学院	大学宁波理工学院
浙江工业大学之江学院	工业大学之江学院
浙江师范大学行知学院	师范大学行知学院
宁波大学科学技术学院	大学科学技术学院
杭州电子科技大学信息工程学院	电子科技大学信息工程学院
浙江理工大学科技与艺术学院	理工大学科技与艺术学院
浙江海洋大学东海科学技术学院	海洋大学东海科学技术学院
浙江农林大学暨阳学院	农林大学暨阳学院
温州医科大学仁济学院	医科大学仁济学院
浙江中医药大学滨江学院	中医药大学滨江学院
杭州师范大学钱江学院	师范大学钱江学院
湖州师范学院求真学院	师范学院求真学院
绍兴文理学院元培学院	文理学院元培学院
温州大学瓯江学院	大学瓯江学院
浙江工商大学杭州商学院	工商大学杭州商学院
中国计量大学现代科技学院	计量大学现代科技学院
浙江财经大学东方学院	财经大学东方学院
嘉兴学院南湖学院	学院南湖学院
温州商学院	商学院
同济大学浙江学院	
上海财经大学浙江学院	财经大学浙江学院
合肥工业大学	工业大学
中国科学技术大学	科学技术大学
安徽大学	
安徽工业大学	工业大学
安徽理工大学	理工大学
安徽工程大学	工程大学
安徽农业大学	农业大学
安徽医科大学	医科大学
蚌埠医学院	医学院
皖南医学院	
安徽中医药大学	中医药大学
安徽师范大学	师范大学
阜阳师范学院	师范学院
安庆师范大学	师范大学
淮北师范大学	师范大学
黄山学院	
皖西学院	
滁州学院	
安徽财经大学	财经大学
宿州学院	
巢湖学院	
淮南师范学院	师范学院
铜陵学院	
安徽建筑大学	建筑大学
安徽科技学院	科技学院
安徽三联学院	三联学院
合肥学院	
蚌埠学院	
池州学院	
安徽新华学院	新华学院
安徽文达信息工程学院	文达信息工程学院
安徽外国语学院	外国语学院
合肥师范学院	师范学院
安徽职业技术学院	职业技术学院
淮北职业技术学院	职业技术学院
芜湖职业技术学院	职业技术学院
淮南联合大学	联合大学
安徽商贸职业技术学院	商贸职业技术学院
安徽水利水电职业技术学院	水利水电职业技术学院
阜阳职业技术学院	职业技术学院
铜陵职业技术学院	职业技术学院
民办万博科技职业学院	
安徽警官职业学院	警官职业学院
淮南职业技术学院	职业技术学院
安徽工业经济职业技术学院	工业经济职业技术学院
合肥通用职业技术学院	通用职业技术学院
安徽工贸职业技术学院	工贸职业技术学院
宿州职业技术学院	职业技术学院
六安职业技术学院	职业技术学院
安徽电子信息职业技术学院	电子信息职业技术学院
民办合肥经济技术职业学院	
安徽交通职业技术学院	交通职业技术学院
安徽体育运动职业技术学院	体育运动职业技术学院
安徽中医药高等专科学校	中医药高等专科学校
安徽医学高等专科学校	医学高等专科学校
亳州学院	
合肥职业技术学院	职业技术学院
滁州职业技术学院	职业技术学院
池州职业技术学院	职业技术学院
宣城职业技术学院	职业技术学院
安徽广播影视职业技术学院	广播影视职业技术学院
民办合肥滨湖职业技术学院	
安徽电气工程职业技术学院	电气工程职业技术学院
安徽冶金科技职业学院	冶金科技职业学院
安徽城市管理职业学院	城市管理职业学院
安徽机电职业技术学院	机电职业技术学院
安徽工商职业学院	工商职业学院
安徽中澳科技职业学院	中澳科技职业学院
阜阳科技职业学院	科技职业学院
亳州职业技术学院	职业技术学院
安徽国防科技职业学院	国防科技职业学院
安庆职业技术学院	职业技术学院
安徽艺术职业学院	艺术职业学院
马鞍山师范高等专科学校	师范高等专科学校
安徽财贸职业学院	财贸职业学院
安徽国际商务职业学院	国际商务职业学院
安徽公安职业学院	公安职业学院
安徽林业职业技术学院	林业职业技术学院
安徽审计职业学院	审计职业学院
安徽新闻出版职业技术学院	新闻出版职业技术学院
安徽邮电职业技术学院	邮电职业技术学院
安徽工业职业技术学院	工业职业技术学院
民办合肥财经职业学院	
安庆医药高等专科学校	医药高等专科学校
安徽涉外经济职业学院	涉外经济职业学院
安徽绿海商务职业学院	绿海商务职业学院
合肥共达职业技术学院	共达职业技术学院
蚌埠经济技术职业学院	经济技术职业学院
民办安徽旅游职业学院	
徽商职业学院	
马鞍山职业技术学院	职业技术学院
安徽现代信息工程职业学院	现代信息工程职业学院
安徽矿业职业技术学院	矿业职业技术学院
合肥信息技术职业学院	信息技术职业学院
桐城师范高等专科学校	
黄山职业技术学院	职业技术学院
滁州城市职业学院	城市职业学院
安徽汽车职业技术学院	汽车职业技术学院
皖西卫生职业学院	
合肥幼儿师范高等专科学校	幼儿师范高等专科学校
安徽长江职业学院	长江职业学院
安徽扬子职业技术学院	扬子职业技术学院
安徽黄梅戏艺术职业学院	黄梅戏艺术职业学院
安徽粮食工程职业学院	粮食工程职业学院
安徽人口职业学院	人口职业学院
合肥科技职业学院	科技职业学院
皖北卫生职业学院	
淮南市职工大学	职工大学
合肥职工科技大学	职工科技大学
合肥市职工大学	职工大学
安徽经济管理干部学院	经济管理干部学院
宿州教育学院	教育学院
安徽广播电视大学	广播电视大学
安徽大学江淮学院	大学江淮学院
安徽师范大学皖江学院	师范大学皖江学院
安徽农业大学经济技术学院	农业大学经济技术学院
安徽医科大学临床医学院	医科大学临床医学院
安徽工业大学工商学院	工业大学工商学院
安徽财经大学商学院	财经大学商学院
淮北师范大学信息学院	师范大学信息学院
安徽建筑大学城市建设学院	建筑大学城市建设学院
安徽信息工程学院	信息工程学院
阜阳师范学院信息工程学院	师范学院信息工程学院
河海大学文天学院	
厦门大学	
华侨大学	
福州大学	
福建工程学院	工程学院
福建农林大学	农林大学
集美大学	
福建医科大学	医科大学
福建中医药大学	中医药大学
福建师范大学	师范大学
闽江学院	
武夷学院	
宁德师范学院	师范学院
泉州师范学院	师范学院
闽南师范大学	
厦门理工学院	理工学院
三明学院	
龙岩学院	
福建警察学院	警察学院
莆田学院	
仰恩大学	
闽南理工学院	
福州外语外贸学院	外语外贸学院
福建江夏学院	江夏学院
泉州信息工程学院	信息工程学院
福建船政交通职业学院	船政交通职业学院
福建商学院	商学院
漳州职业技术学院	职业技术学院
闽西职业技术学院	
黎明职业大学	
福建华南女子职业学院	华南女子职业学院
福州职业技术学院	职业技术学院
福建林业职业技术学院	林业职业技术学院
福建信息职业技术学院	信息职业技术学院
福建水利电力职业技术学院	水利电力职业技术学院
福建电力职业技术学院	电力职业技术学院
厦门海洋职业技术学院	海洋职业技术学院
福建农业职业技术学院	农业职业技术学院
厦门医学院	医学院
福建卫生职业技术学院	卫生职业技术学院
泉州医学高等专科学校	医学高等专科学校
福州英华职业学院	英华职业学院
厦门华厦学院	华厦学院
泉州纺织服装职业学院	纺织服装职业学院
泉州华光职业学院	华光职业学院
泉州理工职业学院	理工职业学院
福建警官职业学院	警官职业学院
闽北职业技术学院	
福州黎明职业技术学院	黎明职业技术学院
厦门演艺职业学院	演艺职业学院
厦门华天涉外职业技术学院	华天涉外职业技术学院
福州科技职业技术学院	科技职业技术学院
泉州经贸职业技术学院	经贸职业技术学院
福建对外经济贸易职业技术学院	对外经济贸易职业技术学院
湄洲湾职业技术学院	
福州理工学院	理工学院
福建生物工程职业技术学院	生物工程职业技术学院
福建艺术职业学院	艺术职业学院
福建幼儿师范高等专科学校	幼儿师范高等专科学校
厦门城市职业学院	城市职业学院
泉州工艺美术职业学院	工艺美术职业学院
三明职业技术学院	职业技术学院
宁德职业技术学院	职业技术学院
福州软件职业技术学院	软件职业技术学院
厦门兴才职业技术学院	兴才职业技术学院
厦门软件职业技术学院	软件职业技术学院
福建体育职业技术学院	体育职业技术学院
漳州城市职业学院	城市职业学院
厦门南洋职业学院	南洋职业学院
厦门东海职业技术学院	东海职业技术学院
漳州科技职业学院	科技职业学院
漳州理工职业学院	理工职业学院
武夷山职业学院	
漳州卫生职业学院	卫生职业学院
泉州海洋职业学院	海洋职业学院
泉州轻工职业学院	轻工职业学院
厦门安防科技职业学院	安防科技职业学院
泉州幼儿师范高等专科学校	幼儿师范高等专科学校
闽江师范高等专科学校	
泉州工程职业技术学院	工程职业技术学院
福建教育学院	教育学院
福建省广播电视大学	广播电视大学
厦门市广播电视大学	广播电视大学
厦门大学嘉庚学院	大学嘉庚学院
阳光学院	
福建师范大学协和学院	师范大学协和学院
福建农林大学东方学院	农林大学东方学院
福建师范大学闽南科技学院	师范大学闽南科技学院
厦门工学院	工学院
集美大学诚毅学院	
福州大学至诚学院	大学至诚学院
福建农林大学金山学院	农林大学金山学院
南昌大学	
华东交通大学	交通大学
东华理工大学	
南昌航空大学	航空大学
江西理工大学	理工大学
景德镇陶瓷大学	陶瓷大学
江西农业大学	农业大学
江西中医药大学	中医药大学
赣南医学院	
江西师范大学	师范大学
上饶师范学院	师范学院
宜春学院	
赣南师范大学	
井冈山大学	
江西财经大学	财经大学
江西科技学院	科技学院
景德镇学院	
萍乡学院	
江西科技师范大学	科技师范大学
南昌工程学院	工程学院
江西警察学院	警察学院
新余学院	
九江学院	
江西工程学院	工程学院
南昌理工学院	理工学院
江西应用科技学院	应用科技学院
江西服装学院	服装学院
南昌工学院	工学院
南昌师范学院	师范学院
江西工业职业技术学院	工业职业技术学院
江西医学高等专科学校	医学高等专科学校
九江职业大学	职业大学
九江职业技术学院	职业技术学院
江西司法警官职业学院	司法警官职业学院
江西陶瓷工艺美术职业技术学院	陶瓷工艺美术职业技术学院
江西旅游商贸职业学院	旅游商贸职业学院
江西电力职业技术学院	电力职业技术学院
江西环境工程职业学院	环境工程职业学院
江西艺术职业学院	艺术职业学院
鹰潭职业技术学院	职业技术学院
江西信息应用职业技术学院	信息应用职业技术学院
江西交通职业技术学院	交通职业技术学院
江西财经职业学院	财经职业学院
江西应用技术职业学院	应用技术职业学院
江西现代职业技术学院	现代职业技术学院
江西工业工程职业技术学院	工业工程职业技术学院
江西机电职业技术学院	机电职业技术学院
江西科技职业学院	科技职业学院
南昌职业学院	职业学院
江西外语外贸职业学院	外语外贸职业学院
江西工业贸易职业技术学院	工业贸易职业技术学院
宜春职业技术学院	职业技术学院
江西应用工程职业学院	应用工程职业学院
江西生物科技职业学院	生物科技职业学院
江西建设职业技术学院	建设职业技术学院
抚州职业技术学院	职业技术学院
南昌师范高等专科学校	师范高等专科学校
江西中医药高等专科学校	中医药高等专科学校
江西先锋软件职业技术学院	先锋软件职业技术学院
江西经济管理职业学院	经济管理职业学院
江西制造职业技术学院	制造职业技术学院
江西工程职业学院	工程职业学院
江西青年职业学院	青年职业学院
上饶职业技术学院	职业技术学院
江西航空职业技术学院	航空职业技术学院
江西农业工程职业学院	农业工程职业学院
赣西科技职业学院	
江西卫生职业学院	卫生职业学院
江西新能源科技职业学院	新能源科技职业学院
江西枫林涉外经贸职业学院	枫林涉外经贸职业学院
江西泰豪动漫职业学院	泰豪动漫职业学院
江西冶金职业技术学院	冶金职业技术学院
江西管理职业学院	管理职业学院
江西传媒职业学院	传媒职业学院
江西工商职业技术学院	工商职业技术学院
景德镇陶瓷职业技术学院	陶瓷职业技术学院
共青科技职业学院	
赣州师范高等专科学校	师范高等专科学校
江西水利职业学院	水利职业学院
宜春幼儿师范高等专科学校	幼儿师范高等专科学校
吉安职业技术学院	职业技术学院
江西洪州职业学院	洪州职业学院
江西行政管理干部学院	行政管理干部学院
昌河职工工学院	
南昌钢铁有限责任公司职工大学	钢铁有限责任公司职工大学
南昌市业余大学	业余大学
南昌市职工科技大学	职工科技大学
江西广播电视大学	广播电视大学
南昌教育学院	教育学院
江西经济管理干部学院	经济管理干部学院
南昌大学科学技术学院	大学科学技术学院
江西农业大学南昌商学院	农业大学南昌商学院
江西师范大学科学技术学院	师范大学科学技术学院
华东交通大学理工学院	交通大学理工学院
江西理工大学应用科学学院	理工大学应用科学学院
东华理工大学长江学院	
南昌航空大学科技学院	航空大学科技学院
江西中医药大学科技学院	中医药大学科技学院
江西财经大学现代经济管理学院	财经大学现代经济管理学院
赣南师范大学科技学院	
景德镇陶瓷大学科技艺术学院	陶瓷大学科技艺术学院
江西科技师范大学理工学院	科技师范大学理工学院
南昌大学共青学院	大学共青学院
山东大学	
中国海洋大学	海洋大学
山东科技大学	科技大学
青岛科技大学	科技大学
济南大学	
青岛理工大学	理工大学
山东建筑大学	建筑大学
齐鲁工业大学	
山东理工大学	理工大学
山东农业大学	农业大学
青岛农业大学	农业大学
潍坊医学院	医学院
泰山医学院	
滨州医学院	医学院
山东中医药大学	中医药大学
济宁医学院	医学院
山东师范大学	师范大学
曲阜师范大学	
聊城大学	
德州学院	
滨州学院	
鲁东大学	
临沂大学	
泰山学院	
济宁学院	
菏泽学院	
山东财经大学	财经大学
山东体育学院	体育学院
山东艺术学院	艺术学院
齐鲁医药学院	
青岛滨海学院	滨海学院
枣庄学院	
山东工艺美术学院	工艺美术学院
青岛大学	
烟台大学	
潍坊学院	
山东警察学院	警察学院
山东交通学院	交通学院
山东工商学院	工商学院
山东女子学院	女子学院
烟台南山学院	南山学院
潍坊科技学院	科技学院
山东英才学院	英才学院
青岛恒星科技学院	恒星科技学院
青岛黄海学院	黄海学院
山东协和学院	协和学院
山东华宇工学院	华宇工学院
青岛工学院	工学院
齐鲁理工学院	
山东政法学院	政法学院
齐鲁师范学院	
山东青年政治学院	青年政治学院
山东管理学院	管理学院
山东农业工程学院	农业工程学院
山东医学高等专科学校	医学高等专科学校
菏泽医学专科学校	医学专科学校
山东商业职业技术学院	商业职业技术学院
山东电力高等专科学校	电力高等专科学校
日照职业技术学院	职业技术学院
曲阜远东职业技术学院	
青岛职业技术学院	职业技术学院
威海职业学院	职业学院
山东职业学院	职业学院
山东劳动职业技术学院	劳动职业技术学院
莱芜职业技术学院	职业技术学院
济宁职业技术学院	职业技术学院
潍坊职业学院	职业学院
烟台职业学院	职业学院
东营职业学院	职业学院
聊城职业技术学院	职业技术学院
滨州职业学院	职业学院
山东科技职业学院	科技职业学院
山东服装职业学院	服装职业学院
德州科技职业学院	科技职业学院
山东力明科技职业学院	力明科技职业学院
山东圣翰财贸职业学院	圣翰财贸职业学院
山东水利职业学院	水利职业学院
山东畜牧兽医职业学院	畜牧兽医职业学院
青岛飞洋职业技术学院	飞洋职业技术学院
东营科技职业学院	科技职业学院
山东交通职业学院	交通职业学院
淄博职业学院	职业学院
山东外贸职业学院	外贸职业学院
青岛酒店管理职业技术学院	酒店管理职业技术学院
山东信息职业技术学院	信息职业技术学院
青岛港湾职业技术学院	港湾职业技术学院
山东胜利职业学院	胜利职业学院
山东经贸职业学院	经贸职业学院
山东工业职业学院	工业职业学院
山东化工职业学院	化工职业学院
青岛求实职业技术学院	求实职业技术学院
山东现代学院	现代学院
济南职业学院	职业学院
烟台工程职业技术学院	工程职业技术学院
山东凯文科技职业学院	凯文科技职业学院
山东外国语职业学院	外国语职业学院
潍坊工商职业学院	工商职业学院
德州职业技术学院	职业技术学院
枣庄科技职业学院	科技职业学院
淄博师范高等专科学校	师范高等专科学校
山东中医药高等专科学校	中医药高等专科学校
济南工程职业技术学院	工程职业技术学院
山东电子职业技术学院	电子职业技术学院
山东旅游职业学院	旅游职业学院
山东铝业职业学院	铝业职业学院
山东杏林科技职业学院	杏林科技职业学院
泰山职业技术学院	
山东外事翻译职业学院	外事翻译职业学院
山东药品食品职业学院	药品食品职业学院
山东商务职业学院	商务职业学院
山东轻工职业学院	轻工职业学院
山东城市建设职业学院	城市建设职业学院
烟台汽车工程职业学院	汽车工程职业学院
山东司法警官职业学院	司法警官职业学院
菏泽家政职业学院	家政职业学院
山东传媒职业学院	传媒职业学院
临沂职业学院	职业学院
枣庄职业学院	职业学院
山东理工职业学院	理工职业学院
山东文化产业职业学院	文化产业职业学院
青岛远洋船员职业学院	远洋船员职业学院
济南幼儿师范高等专科学校	幼儿师范高等专科学校
济南护理职业学院	护理职业学院
泰山护理职业学院	
山东海事职业学院	海事职业学院
潍坊护理职业学院	护理职业学院
潍坊工程职业学院	工程职业学院
菏泽职业学院	职业学院
山东艺术设计职业学院	艺术设计职业学院
威海海洋职业学院	海洋职业学院
山东省水利职工大学	水利职工大学
山东兵器工业职工大学	兵器工业职工大学
新汶矿务局职工大学	
济南市职工大学	职工大学
山东省经济管理干部学院	经济管理干部学院
山东省聊城教育学院	聊城教育学院
山东省济宁教育学院	济宁教育学院
山东省广播电视大学	广播电视大学
兖州矿区职工大学	
山东财政职工大学	财政职工大学
青岛市广播电视大学	广播电视大学
中国石油大学胜利学院	石油大学胜利学院
烟台大学文经学院	大学文经学院
青岛理工大学琴岛学院	理工大学琴岛学院
山东科技大学泰山科技学院	科技大学泰山科技学院
山东财经大学燕山学院	财经大学燕山学院
青岛农业大学海都学院	农业大学海都学院
山东财经大学东方学院	财经大学东方学院
山东师范大学历山学院	师范大学历山学院
聊城大学东昌学院	大学东昌学院
济南大学泉城学院	大学泉城学院
北京电影学院现代创意媒体学院	电影学院现代创意媒体学院
华北水利水电大学	水利水电大学
郑州大学	
河南理工大学	理工大学
郑州轻工业学院	轻工业学院
河南工业大学	工业大学
河南科技大学	科技大学
中原工学院	
河南农业大学	农业大学
河南科技学院	科技学院
河南牧业经济学院	牧业经济学院
河南中医药大学	中医药大学
新乡医学院	医学院
河南大学	
河南师范大学	师范大学
信阳师范学院	师范学院
周口师范学院	师范学院
安阳师范学院	师范学院
许昌学院	
南阳师范学院	师范学院
洛阳师范学院	师范学院
商丘师范学院	师范学院
河南财经政法大学	财经政法大学
郑州航空工业管理学院	航空工业管理学院
黄淮学院	
平顶山学院	
洛阳理工学院	理工学院
新乡学院	
信阳农林学院	农林学院
安阳工学院	工学院
河南工程学院	工程学院
南阳理工学院	理工学院
河南城建学院	城建学院
河南警察学院	警察学院
黄河科技学院	
铁道警察学院	
郑州科技学院	科技学院
郑州工业应用技术学院	工业应用技术学院
郑州师范学院	师范学院
郑州财经学院	财经学院
黄河交通学院	
商丘工学院	工学院
商丘学院	
郑州成功财经学院	成功财经学院
郑州升达经贸管理学院	升达经贸管理学院
河南职业技术学院	职业技术学院
漯河职业技术学院	职业技术学院
三门峡职业技术学院	职业技术学院
郑州铁路职业技术学院	铁路职业技术学院
郑州工程技术学院	工程技术学院
开封大学	
河南工学院	工学院
焦作大学	
河南财政金融学院	财政金融学院
濮阳职业技术学院	职业技术学院
郑州电力高等专科学校	电力高等专科学校
黄河水利职业技术学院	
许昌职业技术学院	职业技术学院
河南工业和信息化职业学院	工业和信息化职业学院
河南水利与环境职业学院	水利与环境职业学院
商丘职业技术学院	职业技术学院
平顶山工业职业技术学院	工业职业技术学院
周口职业技术学院	职业技术学院
济源职业技术学院	
河南司法警官职业学院	司法警官职业学院
鹤壁职业技术学院	职业技术学院
河南工业职业技术学院	工业职业技术学院
郑州澍青医学高等专科学校	澍青医学高等专科学校
焦作师范高等专科学校	师范高等专科学校
河南检察职业学院	检察职业学院
河南质量工程职业学院	质量工程职业学院
郑州信息科技职业学院	信息科技职业学院
漯河医学高等专科学校	医学高等专科学校
南阳医学高等专科学校	医学高等专科学校
商丘医学高等专科学校	医学高等专科学校
郑州电子信息职业技术学院	电子信息职业技术学院
信阳职业技术学院	职业技术学院
嵩山少林武术职业学院	
郑州工业安全职业学院	工业安全职业学院
永城职业学院	
河南经贸职业学院	经贸职业学院
河南交通职业技术学院	交通职业技术学院
河南农业职业学院	农业职业学院
郑州旅游职业学院	旅游职业学院
郑州职业技术学院	职业技术学院
河南信息统计职业学院	信息统计职业学院
河南林业职业学院	林业职业学院
河南工业贸易职业学院	工业贸易职业学院
郑州电力职业技术学院	电力职业技术学院
周口科技职业学院	科技职业学院
河南建筑职业技术学院	建筑职业技术学院
漯河食品职业学院	食品职业学院
郑州城市职业学院	城市职业学院
安阳职业技术学院	职业技术学院
新乡职业技术学院	职业技术学院
驻马店职业技术学院	职业技术学院
焦作工贸职业学院	工贸职业学院
许昌陶瓷职业学院	陶瓷职业学院
郑州理工职业学院	理工职业学院
郑州信息工程职业学院	信息工程职业学院
长垣烹饪职业技术学院	
开封文化艺术职业学院	文化艺术职业学院
河南应用技术职业学院	应用技术职业学院
河南艺术职业学院	艺术职业学院
河南机电职业学院	机电职业学院
河南护理职业学院	护理职业学院
许昌电气职业学院	电气职业学院
信阳涉外职业技术学院	涉外职业技术学院
鹤壁汽车工程职业学院	汽车工程职业学院
南阳职业学院	职业学院
郑州商贸旅游职业学院	商贸旅游职业学院
河南推拿职业学院	推拿职业学院
洛阳职业技术学院	职业技术学院
郑州幼儿师范高等专科学校	幼儿师范高等专科学校
安阳幼儿师范高等专科学校	幼儿师范高等专科学校
郑州黄河护理职业学院	黄河护理职业学院
河南医学高等专科学校	医学高等专科学校
郑州财税金融职业学院	财税金融职业学院
南阳农业职业学院	农业职业学院
洛阳科技职业学院	科技职业学院
鹤壁能源化工职业学院	能源化工职业学院
平顶山文化艺术职业学院	文化艺术职业学院
长城铝业公司职工工学院	
郑州市职工大学	职工大学
第一拖拉机制造厂拖拉机学院	
洛阳轴承职工大学	轴承职工大学
洛阳有色金属职工大学	有色金属职工大学
开封空分设备厂职工大学	空分设备厂职工大学
平顶山教育学院	教育学院
河南省广播电视大学	广播电视大学
焦作职工医学院	职工医学院
磨料磨具工业职工大学	
驻马店教育学院	教育学院
郑州工商学院	工商学院
河南大学民生学院	大学民生学院
中原工学院信息商务学院	
安阳学院	
河南师范大学新联学院	师范大学新联学院
新乡医学院三全学院	医学院三全学院
河南科技学院新科学院	科技学院新科学院
信阳学院	
武汉大学	
华中科技大学	科技大学
武汉科技大学	科技大学
长江大学	
武汉工程大学	工程大学
中国地质大学	地质大学
武汉纺织大学	纺织大学
武汉轻工大学	轻工大学
武汉理工大学	理工大学
湖北工业大学	工业大学
华中农业大学	农业大学
湖北中医药大学	中医药大学
华中师范大学	师范大学
湖北大学	
湖北师范大学	师范大学
黄冈师范学院	师范学院
湖北民族学院	民族学院
湖北文理学院	文理学院
中南财经政法大学	
武汉体育学院	体育学院
湖北美术学院	美术学院
中南民族大学	
湖北汽车工业学院	汽车工业学院
湖北工程学院	工程学院
湖北理工学院	理工学院
湖北科技学院	科技学院
湖北医药学院	医药学院
江汉大学	
三峡大学	
湖北警官学院	警官学院
荆楚理工学院	
武汉音乐学院	音乐学院
湖北经济学院	经济学院
武汉商学院	商学院
武汉东湖学院	东湖学院
汉口学院	
武昌理工学院	
武汉生物工程学院	生物工程学院
武昌工学院	
武汉工商学院	工商学院
文华学院	
武汉工程科技学院	工程科技学院
湖北第二师范学院	第二师范学院
汉江师范学院	
武汉职业技术学院	职业技术学院
黄冈职业技术学院	职业技术学院
长江职业学院	
荆州理工职业学院	理工职业学院
湖北工业职业技术学院	工业职业技术学院
鄂州职业大学	职业大学
武汉城市职业学院	城市职业学院
湖北职业技术学院	职业技术学院
武汉船舶职业技术学院	船舶职业技术学院
恩施职业技术学院	职业技术学院
襄阳职业技术学院	职业技术学院
武汉工贸职业学院	工贸职业学院
荆州职业技术学院	职业技术学院
武汉工程职业技术学院	工程职业技术学院
仙桃职业学院	
湖北轻工职业技术学院	轻工职业技术学院
湖北交通职业技术学院	交通职业技术学院
湖北中医药高等专科学校	中医药高等专科学校
武汉航海职业技术学院	航海职业技术学院
武汉铁路职业技术学院	铁路职业技术学院
武汉软件工程职业学院	软件工程职业学院
湖北三峡职业技术学院	三峡职业技术学院
随州职业技术学院	职业技术学院
武汉电力职业技术学院	电力职业技术学院
湖北水利水电职业技术学院	水利水电职业技术学院
湖北城市建设职业技术学院	城市建设职业技术学院
武汉警官职业学院	警官职业学院
湖北生物科技职业学院	生物科技职业学院
湖北开放职业学院	开放职业学院
武汉科技职业学院	科技职业学院
武汉外语外事职业学院	外语外事职业学院
武汉信息传播职业技术学院	信息传播职业技术学院
武昌职业学院	
武汉商贸职业学院	商贸职业学院
湖北艺术职业学院	艺术职业学院
武汉交通职业学院	交通职业学院
咸宁职业技术学院	职业技术学院
长江工程职业技术学院	
江汉艺术职业学院	
武汉工业职业技术学院	工业职业技术学院
武汉民政职业学院	民政职业学院
鄂东职业技术学院	
湖北财税职业学院	财税职业学院
黄冈科技职业学院	科技职业学院
湖北国土资源职业学院	国土资源职业学院
湖北生态工程职业技术学院	生态工程职业技术学院
三峡电力职业学院	
湖北科技职业学院	科技职业学院
湖北青年职业学院	青年职业学院
湖北工程职业学院	工程职业学院
三峡旅游职业技术学院	
天门职业学院	
湖北体育职业学院	体育职业学院
襄阳汽车职业技术学院	汽车职业技术学院
湖北幼儿师范高等专科学校	幼儿师范高等专科学校
武汉市广播电视大学	广播电视大学
湖北兵器工业职工大学	兵器工业职工大学
湖北省纺织职工大学	纺织职工大学
鄂城钢铁厂职工大学	
丹江口工程管理局职工大学	
湖北省直属机关业余大学	直属机关业余大学
湖北省经济管理干部学院	经济管理干部学院
十堰教育学院	教育学院
荆州教育学院	教育学院
大冶钢厂职工大学	
湖北广播电视大学	广播电视大学
武汉冶金管理干部学院	冶金管理干部学院
湖北武汉公安管理干部学院	武汉公安管理干部学院
华中电业联合职工大学	电业联合职工大学
武昌首义学院	
武汉学院	
武汉华夏理工学院	华夏理工学院
湖北大学知行学院	大学知行学院
三峡大学科技学院	
武汉科技大学城市学院	科技大学城市学院
湖北工业大学工程技术学院	工业大学工程技术学院
湖北商贸学院	商贸学院
武汉工程大学邮电与信息工程学院	工程大学邮电与信息工程学院
武汉纺织大学外经贸学院	纺织大学外经贸学院
江汉大学文理学院	
湖北汽车工业学院科技学院	汽车工业学院科技学院
湖北经济学院法商学院	经济学院法商学院
武汉体育学院体育科技学院	体育学院体育科技学院
湖北师范大学文理学院	师范大学文理学院
湖北工程学院新技术学院	工程学院新技术学院
湖北民族学院科技学院	民族学院科技学院
湖北医药学院药护学院	医药学院药护学院
湖北文理学院理工学院	文理学院理工学院
长江大学文理学院	
长江大学工程技术学院	
武汉传媒学院	传媒学院
武汉设计工程学院	设计工程学院
武汉晴川学院	晴川学院
湖南大学	
中南大学	
湘潭大学	
吉首大学	
湖南科技大学	科技大学
长沙理工大学	理工大学
湖南农业大学	农业大学
中南林业科技大学	
湖南中医药大学	中医药大学
湖南师范大学	师范大学
湖南理工学院	理工学院
湘南学院	
衡阳师范学院	师范学院
邵阳学院	
怀化学院	
湖南文理学院	文理学院
湖南科技学院	科技学院
湖南人文科技学院	人文科技学院
湖南商学院	商学院
南华大学	
长沙医学院	医学院
长沙学院	
湖南工程学院	工程学院
湖南城市学院	城市学院
湖南工学院	工学院
湖南财政经济学院	财政经济学院
湖南警察学院	警察学院
湖南工业大学	工业大学
湖南女子学院	女子学院
湖南第一师范学院	第一师范学院
湖南医药学院	医药学院
湖南涉外经济学院	涉外经济学院
长沙师范学院	师范学院
湖南应用技术学院	应用技术学院
湖南信息学院	信息学院
湖南交通工程学院	交通工程学院
长沙民政职业技术学院	民政职业技术学院
湖南工业职业技术学院	工业职业技术学院
株洲师范高等专科学校	师范高等专科学校
湖南信息职业技术学院	信息职业技术学院
湖南税务高等专科学校	税务高等专科学校
湖南冶金职业技术学院	冶金职业技术学院
长沙航空职业技术学院	航空职业技术学院
湖南大众传媒职业技术学院	大众传媒职业技术学院
永州职业技术学院	职业技术学院
湖南铁道职业技术学院	铁道职业技术学院
湖南科技职业学院	科技职业学院
湖南生物机电职业技术学院	生物机电职业技术学院
湖南交通职业技术学院	交通职业技术学院
湖南商务职业技术学院	商务职业技术学院
湖南体育职业学院	体育职业学院
湖南工程职业技术学院	工程职业技术学院
保险职业学院	
湖南外贸职业学院	外贸职业学院
湖南网络工程职业学院	网络工程职业学院
邵阳职业技术学院	职业技术学院
湖南司法警官职业学院	司法警官职业学院
长沙商贸旅游职业技术学院	商贸旅游职业技术学院
湖南环境生物职业技术学院	环境生物职业技术学院
湖南邮电职业技术学院	邮电职业技术学院
湘潭医卫职业技术学院	医卫职业技术学院
郴州职业技术学院	职业技术学院
娄底职业技术学院	职业技术学院
张家界航空工业职业技术学院	航空工业职业技术学院
长沙环境保护职业技术学院	环境保护职业技术学院
湖南艺术职业学院	艺术职业学院
湖南机电职业技术学院	机电职业技术学院
长沙职业技术学院	职业技术学院
怀化职业技术学院	职业技术学院
岳阳职业技术学院	职业技术学院
常德职业技术学院	职业技术学院
长沙南方职业学院	南方职业学院
潇湘职业学院	
湖南化工职业技术学院	化工职业技术学院
湖南城建职业技术学院	城建职业技术学院
湖南石油化工职业技术学院	石油化工职业技术学院
湖南中医药高等专科学校	中医药高等专科学校
湖南民族职业学院	民族职业学院
湘西民族职业技术学院	民族职业技术学院
湖南财经工业职业技术学院	财经工业职业技术学院
益阳职业技术学院	职业技术学院
湖南工艺美术职业学院	工艺美术职业学院
湖南九嶷职业技术学院	九嶷职业技术学院
湖南理工职业技术学院	理工职业技术学院
湖南软件职业学院	软件职业学院
湖南汽车工程职业学院	汽车工程职业学院
长沙电力职业技术学院	电力职业技术学院
湖南水利水电职业技术学院	水利水电职业技术学院
湖南现代物流职业技术学院	现代物流职业技术学院
湖南高速铁路职业技术学院	高速铁路职业技术学院
湖南铁路科技职业技术学院	铁路科技职业技术学院
湖南安全技术职业学院	安全技术职业学院
湖南电气职业技术学院	电气职业技术学院
湖南外国语职业学院	外国语职业学院
益阳医学高等专科学校	医学高等专科学校
湖南都市职业学院	都市职业学院
湖南电子科技职业学院	电子科技职业学院
湖南国防工业职业技术学院	国防工业职业技术学院
湖南高尔夫旅游职业学院	高尔夫旅游职业学院
湖南工商职业学院	工商职业学院
湖南三一工业职业技术学院	三一工业职业技术学院
长沙卫生职业学院	卫生职业学院
湖南食品药品职业学院	食品药品职业学院
湖南有色金属职业技术学院	有色金属职业技术学院
湖南吉利汽车职业技术学院	吉利汽车职业技术学院
湖南幼儿师范高等专科学校	幼儿师范高等专科学校
湘南幼儿师范高等专科学校	
湖南劳动人事职业学院	劳动人事职业学院
涟源钢铁总厂职工大学	
株洲市职工大学	职工大学
湖南航空工业职工工学院	航空工业职工工学院
中钢集团衡阳重机职工大学	
衡阳工业职工大学	工业职工大学
长沙教育学院	教育学院
湘潭教育学院	教育学院
湖南省广播电视大学	广播电视大学
益阳教育学院	教育学院
湖南金融技术职工大学	金融技术职工大学
湖南纺织职工大学	纺织职工大学
长沙工业职工大学	工业职工大学
湖南师范大学树达学院	师范大学树达学院
湖南商学院北津学院	商学院北津学院
中南林业科技大学涉外学院	
湖南农业大学东方科技学院	农业大学东方科技学院
长沙理工大学城南学院	理工大学城南学院
湖南科技大学潇湘学院	科技大学潇湘学院
湖南工业大学科技学院	工业大学科技学院
湘潭大学兴湘学院	大学兴湘学院
南华大学船山学院	
湖南文理学院芙蓉学院	文理学院芙蓉学院
湖南理工学院南湖学院	理工学院南湖学院
吉首大学张家界学院	
湖南工程学院应用技术学院	工程学院应用技术学院
湖南中医药大学湘杏学院	中医药大学湘杏学院
衡阳师范学院南岳学院	师范学院南岳学院
中山大学	
华南理工大学	理工大学
暨南大学	
汕头大学	
华南农业大学	农业大学
广东海洋大学	海洋大学
广州医科大学	医科大学
广东医科大学	医科大学
广州中医药大学	中医药大学
广东药科大学	药科大学
华南师范大学	师范大学
韶关学院	
惠州学院	
韩山师范学院	
岭南师范学院	
肇庆学院	
嘉应学院	
广州体育学院	体育学院
广州美术学院	美术学院
星海音乐学院	
广东技术师范学院	技术师范学院
深圳大学	
广东财经大学	财经大学
广东白云学院	白云学院
广州大学	
广州航海学院	航海学院
广东警官学院	警官学院
仲恺农业工程学院	
五邑大学	
广东金融学院	金融学院
广东石油化工学院	石油化工学院
东莞理工学院	理工学院
广东工业大学	工业大学
广东外语外贸大学	外语外贸大学
佛山科学技术学院	科学技术学院
广东培正学院	培正学院
南方医科大学	
广东东软学院	东软学院
广州商学院	商学院
广州工商学院	工商学院
广东科技学院	科技学院
广东理工学院	理工学院
广东第二师范学院	第二师范学院
南方科技大学	
北京师范大学-香港浸会大学联合国际学院	师范大学-香港浸会大学联合国际学院
香港中文大学(深圳)	中文大学(深圳)
顺德职业技术学院	
广东轻工职业技术学院	轻工职业技术学院
广东交通职业技术学院	交通职业技术学院
广东水利电力职业技术学院	水利电力职业技术学院
潮汕职业技术学院	
深圳职业技术学院	职业技术学院
民办南华工商学院	
私立华联学院	
广州民航职业技术学院	民航职业技术学院
广州番禺职业技术学院	番禺职业技术学院
广东松山职业技术学院	松山职业技术学院
广东农工商职业技术学院	农工商职业技术学院
广东新安职业技术学院	新安职业技术学院
佛山职业技术学院	职业技术学院
广东科学技术职业学院	科学技术职业学院
广东食品药品职业学院	食品药品职业学院
广州康大职业技术学院	康大职业技术学院
珠海艺术职业学院	艺术职业学院
广东行政职业学院	行政职业学院
广东体育职业技术学院	体育职业技术学院
广东职业技术学院	职业技术学院
广东建设职业技术学院	建设职业技术学院
广东女子职业技术学院	女子职业技术学院
广东机电职业技术学院	机电职业技术学院
广东岭南职业技术学院	岭南职业技术学院
汕尾职业技术学院	职业技术学院
罗定职业技术学院	
阳江职业技术学院	职业技术学院
河源职业技术学院	职业技术学院
广东邮电职业技术学院	邮电职业技术学院
汕头职业技术学院	职业技术学院
揭阳职业技术学院	职业技术学院
深圳信息职业技术学院	信息职业技术学院
清远职业技术学院	职业技术学院
广东工贸职业技术学院	工贸职业技术学院
广东司法警官职业学院	司法警官职业学院
广东亚视演艺职业学院	亚视演艺职业学院
广东省外语艺术职业学院	外语艺术职业学院
广东文艺职业学院	文艺职业学院
广州体育职业技术学院	体育职业技术学院
广州工程技术职业学院	工程技术职业学院
中山火炬职业技术学院	火炬职业技术学院
江门职业技术学院	职业技术学院
茂名职业技术学院	职业技术学院
珠海城市职业技术学院	城市职业技术学院
广州涉外经济职业技术学院	涉外经济职业技术学院
广州南洋理工职业学院	南洋理工职业学院
广州科技职业技术学院	科技职业技术学院
惠州经济职业技术学院	经济职业技术学院
广东工商职业学院	工商职业学院
肇庆医学高等专科学校	医学高等专科学校
广州现代信息工程职业技术学院	现代信息工程职业技术学院
广东理工职业学院	理工职业学院
广州华南商贸职业学院	华南商贸职业学院
广州华立科技职业学院	华立科技职业学院
广州城市职业学院	城市职业学院
广东工程职业技术学院	工程职业技术学院
广州铁路职业技术学院	铁路职业技术学院
广东科贸职业学院	科贸职业学院
广州科技贸易职业学院	科技贸易职业学院
中山职业技术学院	职业技术学院
广州珠江职业技术学院	珠江职业技术学院
广州松田职业学院	松田职业学院
广东文理职业学院	文理职业学院
广州城建职业学院	城建职业学院
东莞职业技术学院	职业技术学院
广东南方职业学院	南方职业学院
广州华商职业学院	华商职业学院
广州华夏职业学院	华夏职业学院
广东环境保护工程职业学院	环境保护工程职业学院
广东青年职业学院	青年职业学院
广州东华职业学院	东华职业学院
广东创新科技职业学院	创新科技职业学院
广东舞蹈戏剧职业学院	舞蹈戏剧职业学院
惠州卫生职业技术学院	卫生职业技术学院
广东信息工程职业学院	信息工程职业学院
广东生态工程职业学院	生态工程职业学院
惠州城市职业学院	城市职业学院
广东碧桂园职业学院	碧桂园职业学院
广州金桥管理干部学院	金桥管理干部学院
南海成人学院	
湛江市业余大学	业余大学
广东省国防工业职工大学	国防工业职工大学
汕头市业余大学	业余大学
韶关市职工大学	职工大学
广州市公安管理干部学院	公安管理干部学院
广东省公安司法管理干部学院	公安司法管理干部学院
广东开放大学	开放大学
广东新华教育学院	新华教育学院
广东省职工体育运动技术学院	职工体育运动技术学院
广东社会科学大学	社会科学大学
广州市广播电视大学	广播电视大学
深圳市广播电视大学	广播电视大学
北京师范大学珠海分校	师范大学珠海分校
成都电子科技大学中山学院	电子科技大学中山学院
广东工业大学华立学院	工业大学华立学院
广州大学松田学院	大学松田学院
北京理工大学珠海学院	理工大学珠海学院
吉林大学珠海学院	大学珠海学院
东莞理工学院城市学院	理工学院城市学院
中山大学新华学院	大学新华学院
华南农业大学珠江学院	农业大学珠江学院
广州大学华软软件学院	大学华软软件学院
广东技术师范学院天河学院	技术师范学院天河学院
中山大学南方学院	大学南方学院
华南理工大学广州学院	理工大学广州学院
广东财经大学华商学院	财经大学华商学院
广东海洋大学寸金学院	海洋大学寸金学院
广东外语外贸大学南国商学院	外语外贸大学南国商学院
广西大学	
广西科技大学	科技大学
桂林电子科技大学	电子科技大学
桂林理工大学	理工大学
广西医科大学	医科大学
右江民族医学院	
广西中医药大学	中医药大学
桂林医学院	医学院
广西师范大学	师范大学
广西师范学院	师范学院
广西民族师范学院	民族师范学院
河池学院	
玉林师范学院	师范学院
广西艺术学院	艺术学院
广西民族大学	民族大学
百色学院	
梧州学院	
广西财经学院	财经学院
南宁学院	
钦州学院	
桂林航天工业学院	航天工业学院
贺州学院	
北海艺术设计学院	艺术设计学院
广西外国语学院	外国语学院
广西机电职业技术学院	机电职业技术学院
广西体育高等专科学校	体育高等专科学校
南宁职业技术学院	职业技术学院
广西科技师范学院	科技师范学院
广西水利电力职业技术学院	水利电力职业技术学院
桂林师范高等专科学校	师范高等专科学校
广西职业技术学院	职业技术学院
桂林旅游学院	旅游学院
柳州职业技术学院	职业技术学院
广西生态工程职业技术学院	生态工程职业技术学院
广西交通职业技术学院	交通职业技术学院
广西工业职业技术学院	工业职业技术学院
广西国际商务职业技术学院	国际商务职业技术学院
广西农业职业技术学院	农业职业技术学院
柳州铁道职业技术学院	铁道职业技术学院
广西建设职业技术学院	建设职业技术学院
广西警察学院	警察学院
广西现代职业技术学院	现代职业技术学院
北海职业学院	职业学院
桂林山水职业学院	山水职业学院
广西经贸职业技术学院	经贸职业技术学院
广西工商职业技术学院	工商职业技术学院
广西演艺职业学院	演艺职业学院
广西电力职业技术学院	电力职业技术学院
广西城市职业学院	城市职业学院
广西英华国际职业学院	英华国际职业学院
柳州城市职业学院	城市职业学院
百色职业学院	职业学院
广西工程职业学院	工程职业学院
广西理工职业技术学院	理工职业技术学院
梧州职业学院	职业学院
广西经济职业学院	经济职业学院
广西幼儿师范高等专科学校	幼儿师范高等专科学校
广西科技职业学院	科技职业学院
广西卫生职业技术学院	卫生职业技术学院
广西培贤国际职业学院	培贤国际职业学院
广西金融职业技术学院	金融职业技术学院
桂林市职工大学	职工大学
广西壮族自治区经济管理干部学院	壮族自治区经济管理干部学院
广西教育学院	教育学院
广西壮族自治区广播电视大学	壮族自治区广播电视大学
广西政法管理干部学院	政法管理干部学院
南宁地区教育学院	地区教育学院
广西师范大学漓江学院	师范大学漓江学院
桂林电子科技大学信息科技学院	电子科技大学信息科技学院
桂林理工大学博文管理学院	理工大学博文管理学院
广西科技大学鹿山学院	科技大学鹿山学院
广西师范学院师园学院	师范学院师园学院
广西民族大学相思湖学院	民族大学相思湖学院
广西大学行健文理学院	大学行健文理学院
广西中医药大学赛恩斯新医药学院	中医药大学赛恩斯新医药学院
北京航空航天大学北海学院	航空航天大学北海学院
海南大学	
海南热带海洋学院	热带海洋学院
海南师范大学	师范大学
海南医学院	医学院
海口经济学院	经济学院
三亚学院	
海南职业技术学院	职业技术学院
三亚城市职业学院	城市职业学院
海南软件职业技术学院	软件职业技术学院
海南政法职业学院	政法职业学院
海南外国语职业学院	外国语职业学院
琼台师范学院	
海南经贸职业技术学院	经贸职业技术学院
海南工商职业学院	工商职业学院
三亚航空旅游职业学院	航空旅游职业学院
海南科技职业学院	科技职业学院
三亚理工职业学院	理工职业学院
海南广播电视大学	广播电视大学
重庆大学	
重庆邮电大学	邮电大学
重庆交通大学	交通大学
重庆医科大学	医科大学
西南大学	
重庆师范大学	师范大学
重庆文理学院	文理学院
重庆三峡学院	三峡学院
长江师范学院	
四川外国语大学	外国语大学
西南政法大学	政法大学
四川美术学院	美术学院
重庆科技学院	科技学院
重庆理工大学	理工大学
重庆工商大学	工商大学
重庆工程学院	工程学院
重庆警察学院	警察学院
重庆人文科技学院	人文科技学院
重庆第二师范学院	第二师范学院
重庆航天职业技术学院	航天职业技术学院
重庆电力高等专科学校	电力高等专科学校
重庆工业职业技术学院	工业职业技术学院
重庆三峡职业学院	三峡职业学院
重庆工贸职业技术学院	工贸职业技术学院
重庆机电职业技术学院	机电职业技术学院
重庆电子工程职业学院	电子工程职业学院
重庆海联职业技术学院	海联职业技术学院
重庆信息技术职业学院	信息技术职业学院
重庆传媒职业学院	传媒职业学院
重庆城市管理职业学院	城市管理职业学院
重庆工程职业技术学院	工程职业技术学院
重庆房地产职业学院	房地产职业学院
重庆城市职业学院	城市职业学院
重庆水利电力职业技术学院	水利电力职业技术学院
重庆工商职业学院	工商职业学院
重庆应用技术职业学院	应用技术职业学院
重庆三峡医药高等专科学校	三峡医药高等专科学校
重庆医药高等专科学校	医药高等专科学校
重庆青年职业技术学院	青年职业技术学院
重庆财经职业学院	财经职业学院
重庆科创职业学院	科创职业学院
重庆建筑工程职业学院	建筑工程职业学院
重庆电讯职业学院	电讯职业学院
重庆能源职业学院	能源职业学院
重庆商务职业学院	商务职业学院
重庆交通职业学院	交通职业学院
重庆化工职业学院	化工职业学院
重庆旅游职业学院	旅游职业学院
重庆安全技术职业学院	安全技术职业学院
重庆公共运输职业学院	公共运输职业学院
重庆艺术工程职业学院	艺术工程职业学院
重庆轻工职业学院	轻工职业学院
重庆电信职业学院	电信职业学院
重庆经贸职业学院	经贸职业学院
重庆幼儿师范高等专科学校	幼儿师范高等专科学校
重庆文化艺术职业学院	文化艺术职业学院
重庆服装工程职业学院	服装工程职业学院
重庆电力职工大学	电力职工大学
重庆冶金成人学院	冶金成人学院
重庆职工会计专科学校	职工会计专科学校
重庆市广播电视大学	广播电视大学
四川外国语大学重庆南方翻译学院	外国语大学重庆南方翻译学院
重庆师范大学涉外商贸学院	师范大学涉外商贸学院
重庆工商大学融智学院	工商大学融智学院
重庆工商大学派斯学院	工商大学派斯学院
重庆邮电大学移通学院	邮电大学移通学院
重庆大学城市科技学院	大学城市科技学院
四川大学	
西南交通大学	交通大学
成都电子科技大学	电子科技大学
西南财经大学	财经大学
西南石油大学	石油大学
成都理工大学	理工大学
西南科技大学	科技大学
成都信息工程大学	信息工程大学
四川理工学院	理工学院
西华大学	
中国民用航空飞行学院	民用航空飞行学院
四川农业大学	农业大学
西昌学院	
西南医科大学	医科大学
成都中医药大学	中医药大学
川北医学院	
四川师范大学	师范大学
西华师范大学	
绵阳师范学院	师范学院
内江师范学院	师范学院
宜宾学院	
四川文理学院	文理学院
乐山师范学院	师范学院
成都体育学院	体育学院
四川音乐学院	音乐学院
西南民族大学	民族大学
成都学院	
成都工业学院	工业学院
攀枝花学院	
四川旅游学院	旅游学院
四川民族学院	民族学院
四川警察学院	警察学院
成都东软学院	东软学院
四川传媒学院	传媒学院
成都文理学院	文理学院
成都医学院	医学院
四川工业科技学院	工业科技学院
四川文化艺术学院	文化艺术学院
成都师范学院	师范学院
四川电影电视学院	电影电视学院
阿坝师范学院	师范学院
成都纺织高等专科学校	纺织高等专科学校
民办四川天一学院	
成都航空职业技术学院	航空职业技术学院
四川电力职业技术学院	电力职业技术学院
成都职业技术学院	职业技术学院
四川化工职业技术学院	化工职业技术学院
四川水利职业技术学院	水利职业技术学院
南充职业技术学院	职业技术学院
内江职业技术学院	职业技术学院
四川航天职业技术学院	航天职业技术学院
四川邮电职业技术学院	邮电职业技术学院
四川机电职业技术学院	机电职业技术学院
绵阳职业技术学院	职业技术学院
四川交通职业技术学院	交通职业技术学院
四川工商职业技术学院	工商职业技术学院
四川工程职业技术学院	工程职业技术学院
四川建筑职业技术学院	建筑职业技术学院
达州职业技术学院	职业技术学院
四川托普信息技术职业学院	托普信息技术职业学院
四川国际标榜职业学院	国际标榜职业学院
成都农业科技职业学院	农业科技职业学院
宜宾职业技术学院	职业技术学院
泸州职业技术学院	职业技术学院
眉山职业技术学院	职业技术学院
成都艺术职业学院	艺术职业学院
四川职业技术学院	职业技术学院
乐山职业技术学院	职业技术学院
雅安职业技术学院	职业技术学院
四川商务职业学院	商务职业学院
四川司法警官职业学院	司法警官职业学院
广安职业技术学院	职业技术学院
四川信息职业技术学院	信息职业技术学院
四川文化传媒职业学院	文化传媒职业学院
四川华新现代职业学院	华新现代职业学院
四川管理职业学院	管理职业学院
四川艺术职业学院	艺术职业学院
四川中医药高等专科学校	中医药高等专科学校
四川科技职业学院	科技职业学院
四川文化产业职业学院	文化产业职业学院
四川财经职业学院	财经职业学院
四川城市职业学院	城市职业学院
四川现代职业学院	现代职业学院
四川幼儿师范高等专科学校	幼儿师范高等专科学校
四川长江职业学院	长江职业学院
四川三河职业学院	三河职业学院
川北幼儿师范高等专科学校	
四川卫生康复职业学院	卫生康复职业学院
四川汽车职业技术学院	汽车职业技术学院
巴中职业技术学院	职业技术学院
四川希望汽车职业学院	希望汽车职业学院
四川电子机械职业技术学院	电子机械职业技术学院
四川文轩职业学院	文轩职业学院
川南幼儿师范高等专科学校	
四川护理职业学院	护理职业学院
成都工业职业技术学院	工业职业技术学院
四川西南航空职业学院	西南航空职业学院
四川科技职工大学	科技职工大学
四川省东方动力职工大学	东方动力职工大学
中国工程物理研究院职工工学院	工程物理研究院职工工学院
四川核工业职工大学	核工业职工大学
成都飞机工业公司职工工学院	飞机工业公司职工工学院
国营涪江机器厂职工大学	
成都电子职工大学	电子职工大学
成都冶金职工大学	冶金职工大学
第五冶金建设公司职工大学	
成都工业职工大学	工业职工大学
四川省化工职工大学	化工职工大学
中国科学院成都分院职工大学	科学院成都分院职工大学
广元职工医学院	职工医学院
南充市职工大学	职工大学
四川广播电视大学	广播电视大学
四川省职工运动技术学院	职工运动技术学院
成都市职工大学	职工大学
成都广播电视大学	广播电视大学
成都理工大学工程技术学院	理工大学工程技术学院
成都信息工程大学银杏酒店管理学院	信息工程大学银杏酒店管理学院
四川工商学院	工商学院
四川外国语大学成都学院	外国语大学成都学院
电子科技大学成都学院	
四川大学锦城学院	大学锦城学院
西南科技大学城市学院	科技大学城市学院
四川大学锦江学院	大学锦江学院
西南财经大学天府学院	财经大学天府学院
西南交通大学希望学院	交通大学希望学院
贵州大学	
贵州医科大学	医科大学
遵义医学院	医学院
贵阳中医学院	中医学院
贵州师范大学	师范大学
遵义师范学院	师范学院
铜仁学院	
兴义民族师范学院	
安顺学院	
贵州工程应用技术学院	工程应用技术学院
凯里学院	
黔南民族师范学院	
贵州财经大学	财经大学
贵州民族大学	民族大学
贵阳学院	
六盘水师范学院	师范学院
贵州师范学院	师范学院
贵州理工学院	理工学院
黔南民族医学高等专科学校	
贵州商学院	商学院
贵州警官职业学院	警官职业学院
贵州交通职业技术学院	交通职业技术学院
贵州航天职业技术学院	航天职业技术学院
贵州电子信息职业技术学院	电子信息职业技术学院
安顺职业技术学院	职业技术学院
黔东南民族职业技术学院	
黔南民族职业技术学院	
遵义职业技术学院	职业技术学院
贵州城市职业学院	城市职业学院
贵州工业职业技术学院	工业职业技术学院
贵州电力职业技术学院	电力职业技术学院
六盘水职业技术学院	职业技术学院
铜仁职业技术学院	职业技术学院
黔西南民族职业技术学院	
贵州轻工职业技术学院	轻工职业技术学院
遵义医药高等专科学校	医药高等专科学校
贵阳护理职业学院	护理职业学院
贵阳职业技术学院	职业技术学院
毕节职业技术学院	职业技术学院
贵州职业技术学院	职业技术学院
贵州盛华职业学院	盛华职业学院
贵州工商职业学院	工商职业学院
贵阳幼儿师范高等专科学校	幼儿师范高等专科学校
铜仁幼儿师范高等专科学校	幼儿师范高等专科学校
黔南民族幼儿师范高等专科学校	
毕节医学高等专科学校	医学高等专科学校
贵州建设职业技术学院	建设职业技术学院
贵州铝厂职工大学	铝厂职工大学
贵州航空职业技术学院	航空职业技术学院
贵州机械工业职工大学	机械工业职工大学
贵州广播电视大学	广播电视大学
贵州大学科技学院	大学科技学院
贵州大学明德学院	大学明德学院
贵州师范大学求是学院	师范大学求是学院
遵义医学院医学与科技学院	医学院医学与科技学院
贵阳中医学院时珍学院	中医学院时珍学院
贵州财经大学商务学院	财经大学商务学院
贵州民族大学人文科技学院	民族大学人文科技学院
贵州医科大学神奇民族医药学院	医科大学神奇民族医药学院
云南大学	
昆明理工大学	理工大学
云南农业大学	农业大学
西南林业大学	林业大学
昆明医科大学	医科大学
大理大学	
云南中医学院	中医学院
云南师范大学	师范大学
昭通学院	
曲靖师范学院	师范学院
普洱学院	
保山学院	
红河学院	
云南财经大学	财经大学
云南艺术学院	艺术学院
云南民族大学	民族大学
玉溪师范学院	师范学院
楚雄师范学院	师范学院
云南警官学院	警官学院
昆明学院	
文山学院	
云南经济管理学院	经济管理学院
云南工商学院	工商学院
昆明冶金高等专科学校	冶金高等专科学校
云南国土资源职业学院	国土资源职业学院
云南交通职业技术学院	交通职业技术学院
昆明工业职业技术学院	工业职业技术学院
云南农业职业技术学院	农业职业技术学院
云南司法警官职业学院	司法警官职业学院
云南文化艺术职业学院	文化艺术职业学院
云南体育运动职业技术学院	体育运动职业技术学院
云南科技信息职业学院	科技信息职业学院
西双版纳职业技术学院	职业技术学院
昆明艺术职业学院	艺术职业学院
玉溪农业职业技术学院	农业职业技术学院
云南能源职业技术学院	能源职业技术学院
云南国防工业职业技术学院	国防工业职业技术学院
云南机电职业技术学院	机电职业技术学院
云南林业职业技术学院	林业职业技术学院
云南城市建设职业学院	城市建设职业学院
云南工程职业学院	工程职业学院
曲靖医学高等专科学校	医学高等专科学校
楚雄医药高等专科学校	医药高等专科学校
保山中医药高等专科学校	中医药高等专科学校
丽江师范高等专科学校	师范高等专科学校
德宏师范高等专科学校	师范高等专科学校
云南新兴职业学院	新兴职业学院
滇西科技师范学院	
云南锡业职业技术学院	锡业职业技术学院
云南经贸外事职业学院	经贸外事职业学院
云南三鑫职业技术学院	三鑫职业技术学院
德宏职业学院	职业学院
云南商务职业学院	商务职业学院
昆明卫生职业学院	卫生职业学院
云南现代职业技术学院	现代职业技术学院
云南旅游职业学院	旅游职业学院
红河卫生职业学院	卫生职业学院
云南外事外语职业学院	外事外语职业学院
大理农林职业技术学院	农林职业技术学院
云南开放大学	开放大学
南方电力职工大学	
云南大学滇池学院	大学滇池学院
云南师范大学商学院	师范大学商学院
云南大学旅游文化学院	大学旅游文化学院
昆明医科大学海源学院	医科大学海源学院
云南艺术学院文华学院	艺术学院文华学院
云南师范大学文理学院	师范大学文理学院
昆明理工大学津桥学院	理工大学津桥学院
西藏大学	
西藏民族大学	民族大学
西藏藏医学院	藏医学院
西藏警官高等专科学校	警官高等专科学校
拉萨师范高等专科学校	师范高等专科学校
西藏职业技术学院	职业技术学院
西安交通大学	交通大学
西北农林科技大学	农林科技大学
长安大学	
西安电子科技大学	电子科技大学
西北工业大学	工业大学
西北大学	
西安理工大学	理工大学
西安工业大学	工业大学
西安建筑科技大学	建筑科技大学
西安科技大学	科技大学
西安石油大学	石油大学
陕西科技大学	科技大学
西安工程大学	工程大学
陕西中医药大学	中医药大学
陕西师范大学	师范大学
延安大学	
陕西理工学院	理工学院
宝鸡文理学院	文理学院
咸阳师范学院	师范学院
渭南师范学院	师范学院
西安外国语大学	外国语大学
西北政法大学	政法大学
西安体育学院	体育学院
西安音乐学院	音乐学院
西安美术学院	美术学院
西安文理学院	文理学院
榆林学院	
商洛学院	
安康学院	
西安培华学院	培华学院
西安财经学院	财经学院
西安邮电大学	邮电大学
西安航空学院	航空学院
西安医学院	医学院
西安欧亚学院	欧亚学院
西安外事学院	外事学院
西安翻译学院	翻译学院
西京学院	
西安思源学院	思源学院
陕西国际商贸学院	国际商贸学院
陕西服装工程学院	服装工程学院
西安交通工程学院	交通工程学院
陕西学前师范学院	学前师范学院
陕西工业职业技术学院	工业职业技术学院
杨凌职业技术学院	
西安电力高等专科学校	电力高等专科学校
陕西能源职业技术学院	能源职业技术学院
陕西国防工业职业技术学院	国防工业职业技术学院
西安航空职业技术学院	航空职业技术学院
陕西财经职业技术学院	财经职业技术学院
陕西交通职业技术学院	交通职业技术学院
陕西职业技术学院	职业技术学院
西安高新科技职业学院	高新科技职业学院
西安城市建设职业学院	城市建设职业学院
陕西铁路工程职业技术学院	铁路工程职业技术学院
宝鸡职业技术学院	职业技术学院
陕西航空职业技术学院	航空职业技术学院
陕西电子信息职业技术学院	电子信息职业技术学院
陕西邮电职业技术学院	邮电职业技术学院
西安海棠职业学院	海棠职业学院
西安汽车科技职业学院	汽车科技职业学院
西安东方亚太职业技术学院	东方亚太职业技术学院
陕西警官职业学院	警官职业学院
陕西经济管理职业技术学院	经济管理职业技术学院
西安铁路职业技术学院	铁路职业技术学院
咸阳职业技术学院	职业技术学院
西安职业技术学院	职业技术学院
商洛职业技术学院	职业技术学院
汉中职业技术学院	职业技术学院
延安职业技术学院	职业技术学院
渭南职业技术学院	职业技术学院
安康职业技术学院	职业技术学院
铜川职业技术学院	职业技术学院
陕西青年职业学院	青年职业学院
陕西工商职业学院	工商职业学院
陕西电子科技职业学院	电子科技职业学院
陕西旅游烹饪职业学院	旅游烹饪职业学院
西安医学高等专科学校	医学高等专科学校
榆林职业技术学院	职业技术学院
陕西艺术职业学院	艺术职业学院
陕西航天职工大学	航天职工大学
陕西机电职业技术学院	机电职业技术学院
西安航空职工大学	航空职工大学
西安飞机工业公司职工工学院	飞机工业公司职工工学院
陕西兵器工业职工大学	兵器工业职工大学
西北电业职工大学	电业职工大学
西安铁路工程职工大学	铁路工程职工大学
西安电力机械制造公司机电学院	电力机械制造公司机电学院
陕西省建筑工程总公司职工大学	建筑工程总公司职工大学
西安市职工大学	职工大学
宝鸡市职工大学	职工大学
西安外贸职工大学	外贸职工大学
陕西省宝鸡教育学院	宝鸡教育学院
陕西省广播电视大学	广播电视大学
陕西工运学院	工运学院
西安市广播电视大学	广播电视大学
西安交通大学城市学院	交通大学城市学院
西北大学现代学院	大学现代学院
西安建筑科技大学华清学院	建筑科技大学华清学院
西安财经学院行知学院	财经学院行知学院
陕西科技大学镐京学院	科技大学镐京学院
西安工业大学北方信息工程学院	工业大学北方信息工程学院
延安大学西安创新学院	大学西安创新学院
西安电子科技大学长安学院	电子科技大学长安学院
西北工业大学明德学院	工业大学明德学院
西安科技大学高新学院	科技大学高新学院
长安大学兴华学院	
西安理工大学高科学院	理工大学高科学院
兰州大学	
西北民族大学	民族大学
兰州理工大学	理工大学
兰州交通大学	交通大学
甘肃农业大学	农业大学
甘肃中医药大学	中医药大学
西北师范大学	师范大学
兰州城市学院	城市学院
陇东学院	
天水师范学院	师范学院
河西学院	
兰州财经大学	财经大学
甘肃政法学院	政法学院
甘肃民族师范学院	民族师范学院
兰州文理学院	文理学院
兰州工业学院	工业学院
兰州石化职业技术学院	石化职业技术学院
甘肃医学院	医学院
陇南师范高等专科学校	师范高等专科学校
定西师范高等专科学校	师范高等专科学校
甘肃建筑职业技术学院	建筑职业技术学院
酒泉职业技术学院	职业技术学院
兰州外语职业学院	外语职业学院
兰州职业技术学院	职业技术学院
甘肃警察职业学院	警察职业学院
甘肃林业职业技术学院	林业职业技术学院
甘肃工业职业技术学院	工业职业技术学院
武威职业学院	职业学院
甘肃交通职业技术学院	交通职业技术学院
兰州资源环境职业技术学院	资源环境职业技术学院
甘肃农业职业技术学院	农业职业技术学院
甘肃畜牧工程职业技术学院	畜牧工程职业技术学院
甘肃钢铁职业技术学院	钢铁职业技术学院
甘肃机电职业技术学院	机电职业技术学院
甘肃有色冶金职业技术学院	有色冶金职业技术学院
白银矿冶职业技术学院	矿冶职业技术学院
甘肃卫生职业学院	卫生职业学院
兰州科技职业学院	科技职业学院
兰州航空工业职工大学	航空工业职工大学
兰州铁路工程职工大学	铁路工程职工大学
甘肃核工业职工大学	核工业职工大学
银光化学材料厂职工大学	
甘肃广播电视大学	广播电视大学
甘肃财贸职业学院	财贸职业学院
西北师范大学知行学院	师范大学知行学院
兰州财经大学陇桥学院	财经大学陇桥学院
兰州交通大学博文学院	交通大学博文学院
兰州财经大学长青学院	财经大学长青学院
兰州理工大学技术工程学院	理工大学技术工程学院
青海大学	
青海师范大学	师范大学
青海民族大学	民族大学
青海卫生职业技术学院	卫生职业技术学院
青海警官职业学院	警官职业学院
青海畜牧兽医职业技术学院	畜牧兽医职业技术学院
青海交通职业技术学院	交通职业技术学院
青海建筑职业技术学院	建筑职业技术学院
西宁城市职业技术学院	城市职业技术学院
青海高等职业技术学院	高等职业技术学院
青海柴达木职业技术学院	柴达木职业技术学院
青海省联合职工大学	联合职工大学
青海省广播电视大学	广播电视大学
青海大学昆仑学院	大学昆仑学院
北方民族大学	民族大学
宁夏大学	
宁夏医科大学	医科大学
宁夏师范学院	师范学院
宁夏理工学院	理工学院
银川能源学院	能源学院
宁夏民族职业技术学院	民族职业技术学院
宁夏工业职业学院	工业职业学院
宁夏职业技术学院	职业技术学院
宁夏工商职业技术学院	工商职业技术学院
宁夏财经职业技术学院	财经职业技术学院
宁夏司法警官职业学院	司法警官职业学院
宁夏建设职业技术学院	建设职业技术学院
宁夏葡萄酒与防沙治沙职业技术学院	葡萄酒与防沙治沙职业技术学院
宁夏幼儿师范高等专科学校	幼儿师范高等专科学校
宁夏艺术职业学院	艺术职业学院
宁夏回族自治区广播电视大学	回族自治区广播电视大学
宁夏大学新华学院	大学新华学院
中国矿业大学银川学院	矿业大学银川学院
新疆大学	
塔里木大学	
新疆农业大学	农业大学
石河子大学	
新疆医科大学	医科大学
新疆师范大学	师范大学
喀什大学	
伊犁师范学院	
新疆财经大学	财经大学
新疆艺术学院	艺术学院
新疆工程学院	工程学院
昌吉学院	
新疆警察学院	警察学院
和田师范专科学校	师范专科学校
新疆农业职业技术学院	农业职业技术学院
乌鲁木齐职业大学	职业大学
新疆维吾尔医学专科学校	维吾尔医学专科学校
克拉玛依职业技术学院	职业技术学院
新疆机电职业技术学院	机电职业技术学院
新疆轻工职业技术学院	轻工职业技术学院
新疆能源职业技术学院	能源职业技术学院
昌吉职业技术学院	职业技术学院
伊犁职业技术学院	
阿克苏职业技术学院	职业技术学院
巴音郭楞职业技术学院	职业技术学院
新疆建设职业技术学院	建设职业技术学院
新疆兵团警官高等专科学校	兵团警官高等专科学校
新疆现代职业技术学院	现代职业技术学院
新疆天山职业技术学院	天山职业技术学院
新疆交通职业技术学院	交通职业技术学院
新疆石河子职业技术学院	石河子职业技术学院
新疆职业大学	职业大学
新疆体育职业技术学院	体育职业技术学院
新疆应用职业技术学院	应用职业技术学院
新疆师范高等专科学校	师范高等专科学校
新疆铁道职业技术学院	铁道职业技术学院
新疆生产建设兵团兴新职业技术学院	生产建设兵团兴新职业技术学院
哈密职业技术学院	职业技术学院
新疆科技职业技术学院	科技职业技术学院
新疆维吾尔自治区钢铁公司职工大学	维吾尔自治区钢铁公司职工大学
新疆生产建设兵团广播电视大学	生产建设兵团广播电视大学
新疆维吾尔自治区广播电视大学	维吾尔自治区广播电视大学
喀什教育学院	教育学院
新疆生产建设兵团教育学院	生产建设兵团教育学院
和田地区教育学院	地区教育学院
阿克苏教育学院	教育学院
新疆大学科学技术学院	大学科学技术学院
新疆农业大学科学技术学院	农业大学科学技术学院
新疆财经大学商务学院	财经大学商务学院
新疆医科大学厚博学院	医科大学厚博学院
石河子大学科技学院	
第二军医大学	
第四军医大学	
国防科学技术大学	
北京现代音乐研修学院	现代音乐研修学院
台湾科技大学	科技大学
台湾师范大学	师范大学
台湾辅仁大学	辅仁大学
台湾大学	
台湾中原大学	中原大学
台湾中山大学	中山大学
台湾政治大学	政治大学
台湾台北大学	台北大学
台湾淡江大学	淡江大学
台湾成功大学	成功大学
台湾东海大学	东海大学
香港科技大学	科技大学
香港中文大学	中文大学
香港公开大学	公开大学
香港城市大学	城市大学
香港大学	
香港浸会大学	浸会大学
香港理工大学	理工大学
澳门大学	
澳门理工学院	理工学院
澳门科技大学	科技大学
上海市化学工业职工大学	化学工业职工大学
上海第二轻工业职工大学	第二轻工业职工大学
盐城幼儿师范高等专科学校	幼儿师范高等专科学校
吉林省行政管理干部学院	行政管理干部学院
南京工程学院康尼学院	工程学院康尼学院
武汉机械工业学校	机械工业学校
九江广播电视大学	广播电视大学
内江广播电视大学	广播电视大学
内蒙古广播电视大学	广播电视大学
北京广播电视大学	广播电视大学
南海广播电视大学	
嘉兴广播电视大学	广播电视大学
天津广播电视大学	广播电视大学
安顺市广播电视大学	广播电视大学
宜昌市广播电视大学	广播电视大学
岳阳广播电视大学	广播电视大学
常德广播电视大学	广播电视大学
广西广播电视大学	广播电视大学
怀化广播电视大学	广播电视大学
新疆广播电视大学	广播电视大学
沈阳广播电视大学	广播电视大学
河北广播电视大学	广播电视大学
河南广播电视大学	广播电视大学
湖南广播电视大学	广播电视大学
襄樊广播电视大学	
邵阳广播电视大学	广播电视大学
郑州广播电视大学	广播电视大学
黄石广播电视大学	广播电视大学
佛山广播电视大学	广播电视大学
重庆广播电视大学	广播电视大学
天津职业大学	职业大学
北京人文大学	人文大学
北京国际商务学院	国际商务学院
北京经济技术研修学院	经济技术研修学院
中国防卫科技学院	防卫科技学院
北京工商管理专修学院	工商管理专修学院
安德烈斯·贝略天主教大学	
委内瑞拉都会大学	
委内瑞拉中央大学	
安第斯大学	
西蒙玻利瓦尔大学	
乌拉圭共和国大学	
蒙得维的亚大学	
亚利桑那州立大学	
奥本大学	
波士顿学院	
布朗大学	
波士顿大学	
贝勒大学	
哥伦比亚大学	
克拉克森大学	
加州理工学院	
美国卡耐基梅隆大学	
南卡罗莱纳大学	
太平洋大学	
科罗拉多州立大学	
康涅狄格大学	
康奈尔大学	
克拉克大学	
纽约市立大学	
凯斯西储大学	
达特茅斯学院	
杜克大学	
德雷克塞尔大学	
埃默里大学	
福特汉姆大学	
佐治亚州立大学	
乔治梅森大学	
佐治亚理工学院	
乔治华盛顿大学	
哈佛大学	
霍华德大学	
美利坚大学	
美国伊利诺理工大学	
辛辛那提大学	
爱荷华州立大学	
印第安纳大学伯明顿分校	
印第安纳大学-普渡大学印第安纳波利斯分校	
约翰霍普金斯大学	
堪萨斯州立大学	
肯特州立大学	
杜兰大学	
路易斯安那州立大学	
芝加哥洛约拉大学	
理海大学	
麻省理工学院	
史密斯学院	
蒙大拿大学	
密歇根州立大学	
密歇根理工大学	
马凯特大学	
北卡罗来纳州立大学	
圣母大学	
新泽西理工学院	
新墨西哥大学	
美国东北大学	
佛罗里达州立大学	
西北大学	
纽约大学	
威克森林大学	
俄克拉荷马大学	
俄亥俄州立大学	
俄勒冈州立大学	
俄克拉何马州立大学	
匹兹堡大学	
宾夕法尼亚州立大学	
普林斯顿大学	
普渡大学	
布兰迪斯大学	
伦斯勒理工大学	
莱斯大学	
罗格斯大学	
纽约州立大学石溪分校	
弗吉尼亚理工大学	
圣地亚哥州立大学	
马萨诸塞大学安姆斯特分校	
斯蒂文斯理工学院	
俄亥俄大学	
南卫理公会大学	
萨凡纳州立大学	
斯坦福大学	
纽约州立大学宾汉姆顿大学	
雪城大学	
德克萨斯A&M大学	
佐治亚大学	
塔夫茨大学	
新学院	
天普大学	
德州理工大学	理工大学
塔尔萨大学	
亚利桑那大学	
阿肯色大学	
加利福尼亚大学伯克利分校	
科罗拉多大学波尔得分校	
加利福尼亚大学戴维斯分校	
科罗拉多大学丹佛分校	
中佛罗里达大学	
芝加哥大学	
加利福尼亚大学尔湾分校	
加利福尼亚大学洛杉矶分校	
加州大学河滨分校	
加州大学圣塔芭芭拉分校	
加利福尼亚大学圣克鲁兹分校	
加利福尼亚大学圣迭戈分校	
丹佛大学	
佛罗里达国际大学	
佛罗里达大学	
休斯敦大学	
伊利诺伊大学芝加哥分校	
伊利诺伊大学厄巴纳-香槟分校	
肯塔基大学	
堪萨斯大学	
密歇根大学	
迈阿密大学	
麻省大学波士顿分校	
马里兰大学巴尔的摩分校	
密苏里大学哥伦比亚分校	
马里兰大学	
明尼苏达大学	
密西西比大学	
北卡罗来纳大学教堂山分校	
新罕布什尔大学	
内布拉斯加大学林肯分校	
俄勒冈大学	
特拉华大学	
爱荷华大学	
罗切斯特大学	
犹他大学	
宾夕法尼亚大学	
阿拉巴马大学	
纽约州立大学布法罗分校	
纽约州立大学奥尔巴尼分校	
南加利福尼亚大学	
圣地亚哥大学	
南佛罗里达大学	
旧金山大学	
犹他州州立大学	
得克萨斯大学奥斯汀分校	
德克萨斯大学达拉斯分校	
田纳西大学诺克斯维尔分校	
佛蒙特大学	
弗吉尼亚大学	
华盛顿大学	
威斯康星大学麦迪逊分校	
怀俄明大学	
范德堡大学	
弗吉尼亚联邦大学	
克莱姆森大学	
威廉与玛丽学院	
伍斯特理工学院	
罗格斯大学	
叶史瓦大学	
华盛顿州立大学	
美国韦恩州立大学	
圣路易斯华盛顿大学	
夏威夷大学马诺阿分校	
杨百翰大学	
耶鲁大学	
乔治敦大学	
密苏里科技大学	
伦敦大学金史密斯学院	
斯特灵大学	
思克莱德大学	
伯恩茅斯大学	
伦敦城市大学	
卡迪夫大学	
埃塞克斯大学	
哈德斯菲尔德大学	
赫瑞•瓦特大学	
帝国理工学院	
阿斯顿大学	
爱丁堡龙比亚大学	
格林威治大学	
伦敦国王学院	
伦敦城市大学	
伦敦南岸大学	
伦敦政治经济学院	
拉夫堡大学	
兰卡斯特大学	
曼彻斯特城市大学	
密德萨斯大学	
诺丁汉特伦特大学	
纽卡斯尔大学	
普利茅斯大学	
伦敦玛丽女王大学	
贝尔法斯特女王大学	
考文垂大学	
伦敦大学皇家霍洛威学院	
罗伯特戈登大学	
伦敦大学亚非学院	
斯旺西大学	
邓迪大学	
布里斯托大学	
剑桥大学	
伦敦大学学院	
中央兰开夏大学	兰开夏大学
杜伦大学	
埃克塞特大学	
东英吉利亚大学	
东伦敦大学	
肯特大学	
利兹大学	
利物浦大学	
诺森比亚大学	
阿伯丁大学	
伯明翰大学	
巴斯大学	
布莱顿大学	
爱丁堡大学	
格拉斯哥大学	
赫尔大学	
赫特福德大学	
曼彻斯特大学	
诺丁汉大学	
谢菲尔德大学	
南安普顿大学	
索尔福德大学	
华威大学	
牛津大学	
约克大学	
布拉德福德大学	
朴次茅斯大学	
雷丁大学	
圣安德鲁斯大学	
阿尔斯特大学	
亚伯大学	
班戈大学	
萨赛克斯大学	
莱斯特大学	
萨里大学	
伦敦大学伯克贝克分校	
布鲁内尔大学	
牛津布鲁克斯大学	
金斯顿大学	
威斯敏斯特大学	
基尔大学	
阿布扎比大学	
迪拜美国大学	
阿联酋大学	
沙迦美国大学	
沙迦大学	
哈利法大学	
顿涅茨克国立大学	
卡拉津哈尔科夫国立大学	
塔拉斯舍甫琴科基辅国立大学	
哈尔科夫国立技术大学理工学院	
苏梅州立大学	
麦克雷雷大学	
萨班哲大学	
比尔肯特大学	
哈西德佩大学	
伊斯坦布尔技术大学	
安卡拉大学	
加齐大学	
伊斯坦布尔大学	
中东科技大学	
丘库罗瓦大学	
玛希隆大学	
清迈大学	
朱拉隆功大学	
孔敬大学	
泰国国王科技大学	
泰国农业大学	
宋卡王子大学	
泰国国立法政大学	
法国洛桑联邦理工学院	
苏黎世联邦理工学院	
弗里堡大学	
圣加仑大学	
巴塞尔大学	
日内瓦大学	
洛桑大学	
伯尔尼大学	
苏黎世大学	
哥德堡大学	
林雪平大学	
瑞典皇家理工学院	
隆德大学	
斯德哥尔摩大学	
于默奥大学	
乌普萨拉大学	
查尔姆斯理工大学	
科伦坡大学	
格拉纳达大学	
卡洛斯国王大学	
穆尔西亚大学	
马德里的Politécnica	
卡洛斯三世马德里大学	
奥维耶多大学	
萨拉曼卡大学	
巴塞罗那自治大学	
马德里自治大学	
巴塞罗那大学	
拉科鲁尼亚大学	
阿尔卡拉大学	
塞维利亚大学	
卡斯蒂利亚-拉曼恰大学	
马德里康普顿斯大学	
纳瓦拉大学	
庞培法布拉大学	
瓦伦西亚理工大学	
巴斯克大学	
圣地亚哥波斯特拉大学	
瓦伦西亚大学	
浦项科技大学	
成均馆大学	
亚洲大学	
忠南国立大学	
韩国天主教大学	
光州科学技术研究所	
汉阳大学	
翰林大学	
韩国外国语大学	
庆熙大学	
韩国高等科学技术研究院	
庆北国立大学	
韩国大学	
全北国立大学	
全南大学	
国立首尔科技大学	
釜山国立大学	
首尔国立大学	
首尔大学	
梨花女子大学	
延世大学	
韩国岭南大学	
西江大学	
东国大学	
世宗大学	
蔚山大学	
仁荷大学	
韩国建国大学	
檀国大学	
约翰内斯堡大学	
比勒陀利亚大学	
夸祖鲁纳塔尔大学	
西北大学	
开普敦大学	
罗德岛大学	
西开普大学	
威特沃特斯兰大学	
斯泰伦博斯大学	
马里博尔大学	
卢布尔雅那大学	
布拉迪斯拉发夸美纽斯大学	
新加坡南洋理工大学	
新加坡国立大学	
新加坡管理大学	
贝尔格莱德大学	
阿卜杜勒阿齐兹国王大学	
费萨尔国王大学	
哈立德国王大学	
法赫德国王石油和矿产大学	
沙特国王大学	
伊玛目穆罕默德伊本沙特伊斯兰大学	
麦加大学	
俄罗斯远东联邦大学	
国立研究型大学高等经济学院	
俄罗斯普列汉诺夫经济大学	
圣光机大学	
萨马拉国立大学	
莫斯科物理技术学院	
罗蒙诺索夫莫斯科国立大学	
鲍曼莫斯科国立技术大学	
国家研究萨拉托夫州立大学	研究萨拉托夫州立大学
新西伯利亚州立大学	
新西伯利亚国立技术大学	
莫斯科国立科技大学	
喀山（伏尔加地区）联邦大学	
南方联邦大学	
彼得大圣彼得堡理工大学	
圣彼得堡州立大学	
国立研究托木斯克理工大学	
莫斯科国立国际关系学院	
托木斯克州立大学	
乌拉尔联邦大学	
沃罗涅日州立大学	
国立核能研究大学-莫斯科工程物理学院	
鲁德大学	
罗巴切夫斯基大学	
库扎大学	
巴比什-波雅依大学	
布加勒斯特大学	
西蒂米什瓦拉大学	
卡塔尔大学	
波多黎各大学	
科英布拉大学	
里斯本大学	
波尔图大学	
阿威罗大学	
米尼奥大学	
葡萄牙大学	
葡萄牙新里斯本大学	
波兹南密茨凯维奇大学	
罗兹大学	
托伦哥白尼大学	
雅盖隆大学	
华沙大学	
华沙技术大学	
弗罗茨瓦夫大学	
弗罗茨瓦夫技术大学	
克拉科夫AGH科技大学	
雅典耀马尼拉大学	
德拉萨尔大学	
菲律宾大学	
圣托马斯大学	
国立圣马科斯大学	
天主教大学天主教大教堂	
秘鲁天主大学	
比尔泽特大学	
拉合尔工程技术大学	
拉合尔管理科学大学	
拉合尔大学	
伊斯兰堡国立科技大学	
巴基斯坦真纳大学	
卡拉奇大学	
苏丹卡布斯大学	
特罗姆瑟大学挪威北极大学	
卑尔根大学	
奥斯陆大学	
挪威科技大学	
奥克兰理工大学	
林肯大学	
梅西大学	
坎特伯雷大学	
奥克兰大学	
怀卡托大学	
惠灵顿维多利亚大学	
奥塔哥大学	
鹿特丹伊拉斯姆斯大学	
莱顿大学	
蒂尔堡大学	
特温特大学	
拉德堡德大学	
埃因霍温理工大学	
代尔夫特理工大学	
格罗宁根大学	
马斯特里赫特大学	
乌得勒支大学	
阿姆斯特丹大学	
瓦赫宁根大学	
阿姆斯特丹自由大学	
穆罕默德五世大学	
泛美大学	
蒙特雷大学	
伊比利亚美洲大学	
蒙特雷高等技术学院	
墨西哥国立理工学院	
墨西哥自治技术学院	
阿纳瓦克大学	
普埃布拉博尼梅瑞塔自治大学	
新莱昂自治大学	
瓜达拉哈拉大学	
墨西哥普埃布拉美洲大学	
墨西哥国立自治大学	
墨西哥国立自治大学	
墨西哥国立自治大学	
马来西亚国际伊斯兰大学	
马来西亚国民大学	
马来亚大学	
马来西亚博特拉大学	
马来西亚理科大学	
马来西亚理工大学	
玛拉工艺大学	
国油科技大学	
马来西亚北方大学	
考纳斯理工大学	
维塔塔斯马格纳斯大学	
维尔纽斯格迪米纳斯技术大学	
维尔纽斯大学	
美国贝鲁特大学	
黎巴嫩美国大学	
圣约瑟夫贝鲁特大学	
拉脱维亚大学	
里加科技大学	
科威特大学	
内罗毕大学	
哈萨克族哈萨克民族教育大学	
吉米廖夫欧亚国立大学	
哈萨克斯坦国立研究技术大学	
南哈萨克斯坦州立大学	
哈英科技大学	
哈萨克斯坦国立大学	
卡拉干达州立大学	
约旦科技大学	
约旦大学	
青山学院大学	
东京医科齿科大学	
广岛大学	
北海道大学	道大学
大阪府立大学	
神户大学	
新泻大学	
熊本大学	
京都大学	
九州大学	
长崎大学	
名古屋工业大学	
名古屋大学	
冈山大学	
大阪市立大学	
大阪大学	
岐阜大学	
金泽大学	
埼玉大学	
东京理科大学	
索菲亚大学	
东京农工大学	
筑波大学	
东京工业大学	
东京都立大学	
东北大学	
群马大学	
信州大学	
东京大学	
早稻田大学	
横滨市立大学	
横滨国立大学	
山口大学	
东海大学	
九州工业大学	
立命馆大学	
明治大学	
同志社大学	
御茶水女子大学	
庆应义塾大学	
一桥大学	
千叶大学	
鹿儿岛大学	
米兰圣心天主教大学	
博洛尼亚大学	
巴里大学	
维罗纳大学	
特伦托大学	
卡塔尼亚大学	
佛罗伦萨大学	
佩鲁贾大学	
罗马第三大学	
热那亚大学	
摩德纳大学和雷焦艾米利亚大学	
米兰比可卡大学	
布雷西亚大学	
那不勒斯大学 - 费德里科二世	
米兰理工大学	
都灵理工大学	
比萨大学	
巴勒摩大学	
罗马第一大学	
罗马第二大学	
锡耶纳大学	
米兰大学	
的里雅斯特大学	
费拉拉大学	
威尼斯大学	
帕维亚大学	
都灵大学	
帕多瓦大学	
内盖夫本-古里安大学	
巴-伊兰大学	
希伯来大学	
特拉维夫大学	
以色列理工学院	
海法大学	
都柏林理工学院	
都柏林城市大学	
国立高威大学	
梅努斯大学	
都柏林大学都柏林三一学院	
科克大学学院	
都柏林大学	
利默里克大学	
库法大学	
巴格达大学	
阿米尔卡比尔技术大学	
沙希德·比什赫蒂大学	
谢里夫理工大学	
德黑兰大学	
伊朗科技大学	
艾尔朗卡大学	
茂物农业大学	
宝拉维加亚大学	
万隆理工学院	
加札马达大学	
梭罗大学	
印度尼西亚大学	
蒂博尼哥罗大学	
旁遮普大学	
阿里格尔穆斯林大学	格尔穆斯林大学
安娜大学	
比尔拉科学技术学院	
日马尼帕尔学院高等教育	
加尔各答大学	
印度科学研究所	
印度理工学院	
印度理工学院古瓦哈蒂	
印度理工学院	
印度德里技术研究所	
印度理工学院坎普尔	
卡哈拉格普尔理工学院	
印度马德拉斯技术学院	
浦那大学	
贝拿勒斯印度大学	
孟买大学	
贾达普大学	
德里大学	
海得拉巴大学	
布达佩斯考文纽斯大学	
德布勒森大学	
匈牙利罗兰大学	
佩奇大学	
塞格德大学	
布达佩斯理工大学	
雅典经济与商业大学	
亚利斯多德塞萨洛尼基大学	
帕特雷大学	
雅典国家技术大学	
雅典大学	
克里特大学	
加纳大学	
波茨坦大学	
哈勒-维腾贝格大学	
比勒费尔德大学	
杜伊斯堡埃森大学	
法兰克福大学	
德国弗莱堡大学	
吉森大学	
海德堡大学	
柏林洪堡大学	
多特蒙德大学	
哥廷根大学	
拜罗伊特大学	
莱布尼茨汉诺威大学	
图宾根大学	
卡尔斯鲁厄理工学院	
慕尼黑-路德维希-马克西米利安大学	
菲利普大学马尔堡	
杜塞尔多夫大学	
鲁尔大学波鸿	
亚琛工业大学	
霍恩海姆大学	
柏林工业大学	
达姆施塔特工业大学	
德累斯顿工业大学	
慕尼黑工业大学	
莱比锡大学	
汉堡大学	
乌尔姆大学	
雷根斯堡大学	
斯图加特大学	
康斯坦茨大学	
曼海姆大学	
不来梅大学	
萨瓦兰德大学	
罗斯托克大学	
约翰内斯古腾堡大学美因茨	
纽伦堡大学	
德国明斯特大学	
耶拿大学	
科隆大学	
柏林自由大学	
波恩莱茵弗里德里希·威廉大学	
基尔大学	
里昂第一大学	
里尔第三大学	
巴黎笛卡尔大学	
法国国立路桥学校	
巴黎高等师范学院	
巴黎高等师范学院	
塞吉-蓬图瓦兹大学	
图卢兹第二大学	
巴黎多芬大学，PSL研究大学	
里昂国家应用科学研究所	
巴黎第十大学	
蒙彼利埃第三大学	
斯特拉斯堡大学	
巴黎索邦大学	
巴黎狄德罗大学	
巴黎第二大学	
巴黎政治大学	
尼斯大学索菲亚安提波利斯大学	
图卢兹第三大学	
图卢兹社会科学第一大学	
蒙彼利埃大学	
雷恩大学	
卡昂大学	
普瓦捷大学	
格勒诺布尔大学	
洛林大学	
卢密耶-里昂第二大学	
南特大学	
巴黎第一大学	
皮埃尔和玛丽居里大学	
里尔大学	
里尔第二大学	
巴黎综合理工大学	
里昂第三大学	
波尔多大学	
里昂高等师范学院	
法国高等电力大学校	
巴黎第十一大学	
艾克斯－马赛大学	
奥伯学术大学	
阿尔托大学	
于韦斯屈莱大学	
东芬兰大学	
拉彭兰塔技术大学	
奥卢大学	
坦佩雷理工大学	
坦佩雷大学	
赫尔辛基大学	
图尔库大学	
塔尔图大学	
塔林理工大学	
亚历山大大学	
艾资哈尔大学	
开罗美国大学	
开罗大学	
艾因沙姆斯大学	
厄瓜多尔天主大学	
基多大学旧金山分校	
奥胡斯大学	
奥尔堡大学	
丹麦技术大学	
哥本哈根大学	
南丹麦大学	
查理大学	
布尔诺技术大学	
马萨里克大学	
帕拉茨基大学	
捷克技术大学	
哈瓦那大学	
萨格勒布大学	
哥斯达黎加大学	
哥斯达黎加国立大学	
哈维里亚那天主教大学	
安蒂奥基亚大学	
哥伦比亚国立大学	
哥伦比亚大学外部	
桑坦德工业大学	
安第斯大学	
罗萨里奥大学	
山谷大学	
哥伦比亚北方大学	
智利天主教大学	
阿道夫·伊瓦涅斯大学	
智利大学	
智利康塞普西翁大学	
智利南方大学	
塔尔卡大学	
天主教大学天主教瓦尔帕莱索	
瓦尔帕莱索大学	
迭亚戈·波塔勒斯大学	
智利圣地亚哥大学	
圣玛丽亚联邦理工大学	
康科迪亚大学	
卡尔顿大学	
达尔豪斯大学	
麦克马斯特大学	
麦吉尔大学	
纽芬兰纪念大学	
约克大学	
瑞尔森大学	
西蒙弗雷泽大学	
渥太华大学	
拉瓦尔大学	
舍布鲁克大学	
不列颠哥伦比亚大学	
卡尔加里大学	
蒙特利尔大学	
圭尔夫大学	
维多利亚大学	
曼尼托巴大学	
阿尔伯塔大学	
魁北克大学	
萨斯喀彻温大学	
多伦多大学	
滑铁卢大学	
西安大略大学	大略大学
温莎大学	
皇后大学	
索非亚大学	
文莱达鲁萨兰国大学	
圣保罗天主教大学	
里奥格兰德天主教大学	
巴西金边大学	
隆德里纳州立大学	
巴伊亚联邦大学	
塞阿拉联邦大学	
弗鲁米嫩塞联邦大学	
巴拉那联邦大学	
米纳斯吉拉斯州联邦大学	
伯南布哥联邦大学	
里约热内卢联邦大学	
Pontifícia里约热内卢天主教大学	
里约热内卢天主大学	
南大河州联邦大学	
圣卡塔琳娜联邦大学	
圣玛丽亚联邦大学	
圣卡洛斯联邦大学	
维索萨联邦大学	
巴西利亚大学	
圣保罗大学	
圣保罗联邦大学	
圣保罗州立大学	
列日大学	
根特大学	
鲁汶大学	
蒙斯大学	
鲁汶天主教大学	
安特卫普大学	
比利时布鲁塞尔自由大学	
白俄罗斯国立大学	
白俄罗斯国立技术大学	
达卡大学	
阿拉伯海湾大学	
巴林大学	
国立巴库大学	
哈扎尔大学	
因斯布鲁克大学	
格拉茨技术大学	
克拉根福大学	
萨尔斯堡大学	
维也纳科技大学	
维也纳大学	
约翰内斯开普勒大学林茨	
澳大利亚天主教大学	
澳大利亚国立大学	
邦德大学	
查尔斯·达尔文大学	
中央昆士兰大学	昆士兰大学
查尔斯特大学	
科廷大学	
迪肯大学	
伊迪丝科文大学	
南澳大学	
詹姆斯库克大学	
拉筹伯大学	
默多克大学	
麦考瑞大学	
莫纳什大学	
昆士兰科技大学	
斯威本科技大学	
堪培拉大学	
维多利亚大学	
南十字星大学	
新英格兰大学	
新南威尔士大学	
阿德莱德大学	
澳大利亚纽卡斯尔大学	
伍伦贡大学	
昆士兰大学	
阳光海岸大学	
南昆士兰大学	
悉尼大学	
悉尼科技大学	
西悉尼大学	
墨尔本大学	
西澳大利亚大学	
皇家墨尔本理工大学	
塔斯马尼亚大学	
格里菲斯大学	
弗林德斯大学	
南方大学	
阿根廷托尔夸托迪特加大学	
布宜诺斯艾利斯技术学院	
国立马德普拉塔大学	
天主教大学天主教阿根廷	
布宜诺斯艾利斯大学	
贝尔格拉诺大学	
巴勒莫大学	
科尔多瓦国立大学	
拉普拉塔国立大学	
国立库约大学	
图库曼国立大学	
国立罗萨里奥大学	
国立南方大学	
圣安德烈斯大学	
阿根廷国立理工大学	
school	alias
安徽工程大学	ahpu
安徽工业大学	ahut
安徽大学	ahu
安徽建筑大学	ajzu
安徽医科大学	amu
安徽师范大学	anu
安徽财经大学	aufe
河北农业大学	auh
北京舞蹈学院	bda
北京外国语大学	bei
北京外国语大学	bfsu
北华大学	bhu
北京信息科技大学	bistu
北京交通大学	bjtu
北京师范大学	bnu
北京航空航天大学	buaa
北京邮电大学	bupt
中国民航大学	cauc
中国农业大学	cau
华中师范大学	ccnu
长春工业大学	ccut
成都理工大学	cdut
香港城市大学	cityu
常州工学院	cit
中国计量大学	cjlu
中国医科大学	cmu
首都师范大学	cnu
中国药科大学	cpu
重庆交通大学	cqjtu
重庆医科大学	cqmu
重庆师范大学	cqnu
长沙理工大学	csust
重庆工商大学	ctbu
重庆三峡职业学院	ctgpc
三峡大学	ctgu
中国传媒大学	cuc
首都经济贸易大学	cueb
中央财经大学	cufe
中国地质大学	cugb
香港中文大学	cuhk
成都信息工程大学	cuit
中国矿业大学	cumtb
中国政法大学	cupl
长春理工大学	cust
台湾中原大学	cycu
中国青年政治学院	cyu
常州大学	czu
东华大学	dhu
大连海洋大学	dlou
大连海事大学	dmu
大连海洋大学	dou
防灾科技学院	dpst
东北财经大学	dufe
大连外国语大学	dufl
大连理工大学	dut
华东交通大学	ecjtu
华东师范大学	ecnu
华东政法大学	ecupl
复旦大学	fdu
福建师范大学	fjnu
福建工程学院	fjut
复旦大学	fudan
福州大学	fzu
广东海洋大学	gdou
广东金融学院	gduf
贵州民族大学	gmu
广西中医药大学赛恩斯新医药学院	grace
甘肃农业大学	gsau
广西师范学院	gteu
广西中医药大学	gucm
广西医科大学	gxmu
广西科技大学	gxust
广西科技大学	广科大
广西科技大学	柳州医学高等专科学校
贵州师范大学	gznu
贵州财经大学	gzufe
河南科技大学	haust
河南工业大学	haut
湖北经济学院	hbue
湖北工业大学	hbut
河北大学	hbu
河北工业大学	hebut
河南大学	henu
哈尔滨工程大学	heu
合肥师范学院	hfnu
合肥工业大学	hfut
合肥学院	hfuu
河海大学	hhu
哈尔滨工业大学	hit
香港大学	hku
河南农业大学	hnau
河南牧业经济学院	郑州牧业工程高等专科学校
河南理工大学	hpu
湖北工程学院新技术学院	hubei engineering university
湖北工程学院新技术学院	孝感学院新技术学院
湖北大学	hubu
湖南中医药大学	hucm
河北经贸大学	hueb
华中科技大学	hust
河南中医药大学	hutcm
红河学院	hu
华中农业大学	hzau
内蒙古农业大学	imau
内蒙古医科大学	immu
内蒙古师范大学	imnu
内蒙古科技大学	imust
内蒙古工业大学	imut
澳门理工学院	ipm
景德镇陶瓷大学科技艺术学院	jciky
吉林财经大学	jlufe
佳木斯大学	jmsu
江南大学	jnu
吉首大学	jsu
江西理工大学	jxust
昆明理工大学	kmust
喀什大学	knu
鲁东大学	ldu
洛阳理工学院	lit
辽宁工程技术大学	lntu
兰州理工大学	lut
兰州交通大学	lzjtu
中央民族大学	muc
中国戏曲学院	nacta
华北电力大学	ncepu
南昌大学	ncu
华北水利水电大学	ncwu
东北电力大学	nedu
东北石油大学	nepu
东北大学	neu
南京工程学院	njit
南京理工大学	njust
南京大学	nju
南开大学	nku
西北工业大学	npu
川北医学院	nsmc
烟台南山学院	nsu
南京航空航天大学	nuaa
中北大学	nuc
国防科学技术大学	nudt
南京信息工程大学	nuist
南京邮电大学	nupt
西北师范大学	nwnu
西北民族大学	nwun
西北政法大学	nwupl
宁夏医科大学	nxmu
宁夏大学	nxu
中国海洋大学	ouc
香港公开大学	ouhk
北京大学	pku
香港理工大学	polyu
中国人民公安大学	ppsuc
攀枝花学院	pzhu
青岛农业大学	qau
青岛大学	qdu
青海大学	qhu
青岛理工大学	qtu
青岛科技大学	qust
中国人民大学	ruc
上海商学院	sbs
华南农业大学	scau
湖南人文科技学院	science and technology
华南师范大学	scnu
山东农业大学	sdau
东南大学	seu
山东财经大学	山东财政学院
山东财经大学东方学院	山东财政学院东方学院
上海师范大学	shnu
上海政法学院	shupl
上海大学	shu
四川农业大学	sicau
四川大学	sichuan university
四川师范大学	sicnu
四川外国语大学	sisu
上海交通大学	sjtu
上海建桥学院	sju
沈阳建筑大学	sjzu
陕西师范大学	snnu
沈阳药科大学	spu
上海第二工业大学	sspu
石家庄铁道大学	stu
上海工程技术大学	sues
上海财经大学	sufe
西南政法大学	supsl
四川理工学院	suse
陕西科技大学	sust
西南财经大学	swufe
西南民族大学	swun
西南科技大学	swust
山西农业大学	sxau
山西师范大学	sxnu
山西财经大学	sxufe
山西大学	sxu
沈阳农业大学	syau
沈阳理工大学	sylu
中山大学	sysu
邵阳学院	syu
深圳大学	szu
天津外国语大学	tfsu
清华大学	thu
太原工业学院	tit
天津大学	tju
清华大学	tsinghua
天津商业大学	tuc
天津中医药大学	tutcm
西藏大学	tu
太原理工大学	tyut
对外经济贸易大学	uibe
宁波诺丁汉大学	unnc
南华大学	usc
上海理工大学	usst
山西信息职业技术学院	vcit
北京外国语大学	wai
武汉航海职业技术学院	whmi
武汉理工大学	whut
武汉大学	whu
武汉工程大学	wit
武汉纺织大学	wtu
武汉科技大学	wust
五邑大学	wu
武夷学院	wyu
新疆艺术学院	xai
西安建筑科技大学	xauat
新疆农业大学	xau
西华大学	xhu
西安外国语大学	xisu
新疆师范大学	xjnu
西交利物浦大学	xjtlu
西安交通大学	xjtu
新疆大学	xju
厦门大学	xmu
西安工程大学	xpu
湘潭大学	xtu
宜春学院	ycu
云南师范大学	ynnu
云南财经大学	ynufe
云南中医学院	ynutcm
燕山大学	ysu
浙江工商职业技术学院	zjbti
浙江经贸职业技术学院	zjetp
浙江大学	zju
周口职业技术学院	zkvtc
浙江海洋大学	zou
中南财经政法大学	zuel
浙江万里学院	zwu
郑州航空工业管理学院	zzia
郑州大学	zzu
阿坝师范学院	阿坝师专
阿坝师范学院	阿坝师范高等专科学校
安徽财经大学	安财
安徽大学	安大
安阳工学院	安工
安徽工程大学	安工程
安徽工业大学	安工大
安徽工商职业学院	安工商
安徽广播影视职业技术学院	安广院
安徽职业技术学院	安徽材料工程学校
安徽财经大学	安徽财贸学院
安徽电子信息职业技术学院	安徽电子学院
安徽职业技术学院	安徽纺织职业技术学院
合肥工业大学	安徽工学院
安徽职业技术学院	安徽工业经济学校
淮北职业技术学院	安徽广播电视大学淮北分校
安徽工程大学	安徽机电学院
安徽建筑大学	安徽建筑工业学院
安徽科技学院	安徽科技师范学院
安徽科技学院	安徽农业技术师范学院
安徽科技学院	安徽技术师范学院
安徽工业大学	安徽商业高等专科学校
安徽职业技术学院	安徽省轻工业学校
铜陵学院	安徽省冶金工业学校
安徽体育运动职业技术学院	安徽体院
安徽外国语学院	安徽外院
安徽外国语学院	安徽外国语职业技术学院
安徽医科大学	安徽医大
安徽中医药大学	安徽中医学院
安徽中医药高等专科学校	安徽中医药高专
安徽建筑大学	安建大
安康职业技术学院	安康职院
安徽农业大学	安农
安徽农业大学	安农大
安庆师范大学	安庆师院
安庆师范大学	安庆师大
安庆师范大学	安庆师范学院
安徽师范大学	安师大
安顺市广播电视大学	安顺电大
安顺学院	安顺教育学院
安顺学院	安顺师范专科学校
安阳师范学院	安阳教育学院
安阳师范学院	安阳师范高等专科学校
安阳师范学院	安阳师院
安徽中医药大学	安中
安徽中医药大学	安中医
安徽中医药大学	安徽中医大学
安徽中医药大学	安徽中医学院
鞍山钢铁集团公司职工大学	鞍钢职工工学院
辽宁科技大学	鞍山大学
辽宁科技大学	鞍山市高等职业专科学校
辽宁科技大学	鞍山钢铁学院
辽宁科技大学	鞍山科技大学
辽宁科技大学	鞍山市电大
鞍山师范学院	鞍山师范专科学校
鞍山钢铁集团公司职工大学	鞍山冶金管理干部学院
鞍山师范学院	鞍师
澳门大学	澳大
澳门理工学院	澳理工
四川核工业职工大学	八一二厂职工工学院
黑龙江八一农垦大学	八一农大
白城医学高等专科学校	白城医专
吉林大学	白求恩医科大学
广东白云学院	白云学院
百色职业学院	百色职院
百色学院	百院
蚌埠学院	蚌埠食品工业专科学校
蚌埠学院	蚌埠联合大学
蚌埠学院	蚌埠高等专科学校
蚌埠学院	蚌埠教育学院
内蒙古科技大学	包师院
内蒙古科技大学	包头钢铁学院
包头职业技术学院	包头机械工业学校
内蒙古科技大学	包头教育学院
内蒙古科技大学	包头师范高等专科学校
内蒙古科技大学	包头师范学校
内蒙古科技大学	包头师范学院
内蒙古科技大学	包头医学院
保定学院	保定地区教育学院
保定学院	保定师范专科学校
西安航空职工大学	宝成通用电子公司职工工学院
宝鸡文理学院	宝大
宝鸡文理学院	宝鸡大学
宝鸡文理学院	宝鸡师院
宝鸡文理学院	宝文理
北京城市学院	北城
北京城市学院	北京现代职业技术学院
北京城市学院	北京现代职院
北京大学	北大
北京北大方正软件职业技术学院	北大方正软件学院
北京北大方正软件职业技术学院	北大方正软件技术学院
北京电影学院	北电
北方民族大学	北方民大
北京服装学院	北服
北京工业大学	北工大
北京工商大学	北工商
中国传媒大学	北广
北京航空航天大学	北航
北华大学	北华
北京化工大学	北化
北京建筑大学	北建大
首都经济贸易大学	北京财贸学院
北京财贸职业学院	北京财政学校
北京财贸职业学院	北京市立信会计职工大学
北京财贸职业学院	北京市财贸管理干部学院
北京广播电视大学	北京电大
北京交通大学	北京电力高等专科学校
北京交通大学	北方交通大学
华北电力大学	北京动力经济学院
中国传媒大学	北京广播学院
北京化工大学	北京化工管理干部学院
北京工业大学	北京计算机学院
北京建筑大学	北京建筑工程学院
北京交通大学	北京交大
北京教育学院	北京教育行政学院
北京京北职业技术学院	北京京北职院
北京经济管理职业学院	北京经管职院
首都经济贸易大学	北京经济学院
北京联合大学	北京联大
中国矿业大学	北京煤炭管理干部学院
中国农业大学	北京农业大学
中国农业大学	北京农业工程大学
南京信息工程大学	北京气象学院
北京工商大学	北京轻工业学院
北京工商大学	北京商学院
北京教育学院	北京实验大学
北京教育学院	北京市成人教育学院
北京市西城经济科学大学	北京市西城区职工大学
北京工业大学	北京水利电力函授学院
首都体育学院	北京体育师范学院
北京科技大学	北京冶金管理干部学院
首都医科大学	北京医学高等专科学校
北京工业大学	北京艺术设计职业学院
北京语言大学	北京语言文化大学
北京中医药大学	北京针灸骨伤学院
首都医科大学	北京职工医学院
北京科技大学	北科大
北京理工大学	北理工
北京林业大学	北林
北京师范大学	北师大
北京体育大学	北体
北京体育大学	北体大
北京外国语大学	北外
北京舞蹈学院	北舞
北京大学	puhsc
北京大学	北医
北京大学	北京医科大学
北京印刷学院	北印
北京电影学院	北影
北京邮电大学	北邮
大同煤炭职业技术学院	北岳职业技术学院
北京中医药大学	北中医
辽宁科技学院	本溪高等职业专科学校
辽宁科技学院	本溪师范高等专科学校
辽宁科技学院	本溪冶金高等专科学校
辽宁科技学院	
辽宁科技学院	本溪市电大
辽宁科技学院	本溪市高等职业专科学校
辽宁科技学院	本溪大学
辽宁科技学院	本溪市教育学院
辽宁科技学院	本溪师范专科学校
贵州工程应用技术学院	毕节教育学院
贵州工程应用技术学院	毕节师范高等专科学校
贵州工程应用技术学院	毕节学院
滨州医学院	滨医
滨州学院	滨院
滨州职业学院	滨职
沧州师范学院	沧州师院
沧州师范学院	沧州师范专科学校
沧州医学高等专科学校	沧州医专
南昌大学	昌大
南昌航空大学	昌航
昌吉学院	昌吉师范专科学校
昌吉学院	昌吉州教育学院
潍坊学院	昌潍师范专科学校
常州大学	常大
常德广播电视大学	常德电大
湖南幼儿师范高等专科学校	常德高等专科学校
湖南幼儿师范高等专科学校	常德师范高等专科学校
湖南幼儿师范高等专科学校	常德师范学院
湖南文理学院	常德师范学校
常州纺织服装职业技术学院	常纺
常州工学院	常工院
常熟理工学院	常熟理工
常州纺织服装职业技术学院	常州纺院
常州工学院	常州工业技术学院
江苏理工学院	常州技术师范学院
常州市职工大学	常州市纺织工业职工大学
常州工学院	常州市机械冶金职工大学
常州市职工大学	常州市建材职工大学
常州市职工大学	常州市建筑职工大学
常州工学院	常州市轻工业职工大学
河海大学	常州水电机械制造职工大学
重庆机电职业技术学院	长安机器制造厂职工大学
长春工程学院	长春工程
长春工业大学	长春工大
长春工程学院	长春工业高等专科学校
长春理工大学	长春光学精密机械学院
长春工程学院	长春建筑高等专科学校
吉林大学	长春科技大学
长春理工大学	长春煤炭管理干部学院
长春师范大学	长春师大
长春师范大学	长春师大
长春师范大学	长春师范学院
长春广播电视大学	长春市成人文理学院
长春广播电视大学	长春市广播电视大学
长春工程学院	长春水利电力高等专科学校
吉林财经大学	长春税务学院
长春医学高等专科学校	长春医专
吉林大学	长春邮电学院
长春中医药大学	长春中医学院
长江工程职业技术学院	长工职
重庆机电职业技术学院	长江电工厂职工大学
长江工程职业技术学院	长江工院
长春金融高等专科学校	长金高专
长春金融高等专科学校	长金专
长春理工大学	长理
长沙理工大学	长沙电力学院
中南大学	长沙工业高等专科学校
长沙理工大学	长沙交通学院
长沙理工大学	长沙理工
长沙民政职业技术学院	长沙民政学院
长沙工业职工大学	长沙市电子职工大学
长沙工业职工大学	长沙机械电子职工大学
长沙工业职工大学	长沙市冶金机械职工大学
中南大学	长沙铁道学院
长沙学院	长沙职业技术师范专科学校
长沙学院	长沙大学
长江师范学院	长师
合肥职业技术学院	巢湖职业技术学院
湘南学院	郴州教育学院
湘南学院	郴州师范高等专科学校
湘南学院	郴州医学高等专科学校
成都电子科技大学	成电
昆明理工大学	成都电子科大昆明分部
成都纺织高等专科学校	成都纺专
成都航空职业技术学院	成都航院
四川大学	成都科技大学
成都理工大学	成都理工
成都理工大学	成都理工学院
成都工业职工大学	成都量具刃具厂职工大学
四川师范大学	成都煤炭管理干部学院
成都信息工程大学	成都气象学院
西华大学	成都师范高等专科学校
成都工业职工大学	成都市二轻局职工大学
成都工业职工大学	成都市医药局职工大学
成都信息工程大学	成都信息工程学院
成都信息工程大学银杏酒店管理学院	成都信息工程学院银杏酒店管理学院
成都电子科技大学	成都冶金管理干部学院
成都理工大学	成都有色地质职工大学
成都工业学院	成工院
成都工业学院	成都电子机械高等专科学校
成都信息工程大学	成信
成都职业技术学院	成职院
承德石油高等专科学校	承德石油高专
承德医学院	承医
赤峰学院	赤峰教育学院
赤峰学院	赤峰民族师范高等专科学校
楚雄师范学院	楚雄民族师范学校
楚雄师范学院	楚雄师范高等专科学校
四川大学	川大
四川科技职业学院	川科职院
四川理工学院	川理
四川旅游学院	sctu
四川旅游学院	川旅
四川旅游学院	川旅院
四川旅游学院	四川省农业管理干部学院
四川旅游学院	四川农业管理干部学院
四川农业大学	川农
四川师范大学	川师
四川外国语大学成都学院	川外成都学院
四川外国语大学成都学院	四川外语学院成都学院
四川外国语大学	川外
四川外国语大学重庆南方翻译学院	川外重庆南方翻译学院
四川外国语大学重庆南方翻译学院	四川外语学院重庆南方翻译学院
四川音乐学院	川艺大
四川音乐学院	四川艺术大学
四川音乐学院	川音
大连理工大学	大工
大连海洋大学	大海大
大理大学	大理师范高等专科学校
大理大学	大理学院
大理大学	大理医学院
大连工业大学	大连工大
大连工业大学	大连工业
大连海事大学	大连海大
大连交通大学	大连交大
大连交通大学	大连交大
大连交通大学	大连交通
大连工业大学	大连轻工业学院
大连海洋大学	大连水产学院
大连交通大学	大连铁道学院
大连外国语大学	大连外国语学院
辽东学院	大连医科大学丹东分校
东北石油大学	大庆石油学院
大庆医学高等专科学校	大庆医专
大连软件职业学院	大软
山西大同大学	大同高等专科学校
山西大同大学	大同市教育学院
山西大同大学	大同医学专科学校
山西大同大学	大同职业技术学院
山西大同大学	大同大学
大连外国语大学	大外
大兴安岭职业学院	大兴安岭职院
大连艺术学院	大艺
大连翻译职业学院	大译
大理大学	大院
山西机电职工学院	大众机械厂职工大学
辽东学院	丹东纺织高等专科学校
辽东学院	丹东师范高等专科学校
辽东学院	丹东师范
辽东学院	丹东市电大
辽东学院	丹东大学
辽东学院	丹东市轻纺工业专科学校
辽东学院	丹东纺织高等专科学校
辽东学院	丹东市教育学院
辽东学院	丹东师范专科学校
辽东学院	丹东职业技术学院
四川工程职业技术学院	德阳机校
四川建筑职业技术学院	德阳建院
四川建筑职业技术学院	四川建筑学院
德州学院	德院
德州学院	德州教育学院
德州学院	德州师范专科学校
德州学院	德州市直机关业余大学
德州学院	德州高等专科学校
德州学院	德州大学
中国地质大学	地大北京
中国地质大学	地大
中国地质大学	中国地质大学（武汉）
中国地质大学	中国地质大学（北京）
中国地质大学	中国地质大学(武汉)
中国地质大学	中国地质大学(北京)
四川核工业职工大学	第一研究设计院职工大学
上海电影艺术职业学院	上海电影艺术学院
北京信息科技大学	电子工业管理干部学院
北京信息科技大学	北京成人电子工业学院
北京信息科技大学	北京信息工程学院
成都电子科技大学	电子科大
成都电子科技大学	西南电子科技大学
成都电子科技大学	电子科技大学
定西师范高等专科学校	定西师专
哈尔滨航空职工大学	东安发动机制造公司职工工学院
东北电力大学	东北电力学院
辽宁兵器工业职工大学	东北机器制造厂职工大学
东北林业大学	东北林大
东北农业大学	东北农学院
东北师范大学	东北师大
东北财经大学	东财
东北电力大学	东电
东莞理工学院	东莞理工
东华理工大学	东华理工学院
东华理工大学	东理工
东北林业大学	东林
东北农业大学	东农
大连东软信息学院	东软信息学院
大连东软信息学院	大连东软信息技术职业学院
东北石油大学	东油
黔南民族师范学院	都匀民族师范学校
鄂州职业大学	鄂大
鄂州职业大学	鄂州大学
湖北民族学院	恩施医学高等专科学校
恩施职业技术学院	恩施职院
上海第二工业大学	二工大
中国政法大学	法大
防灾科技学院	防科
武汉纺织大学	纺大
广州大学	纺织学院
西安航空职工大学	飞行试验研究院职工工学院
山西煤炭职工联合大学	汾西矿务局职工大学
云南警官学院	奉献
佛山科学技术学院	fsu
佛山科学技术学院	佛科院
佛山科学技术学院	佛山科技学院
佛山科学技术学院	佛山大学
佛山广播电视大学	佛山电大
佛山职业技术学院	佛山机电学校
佛山职业技术学院	佛山煤田职工地质学院
佛山科学技术学院	佛山农牧高等专科学校
佛山科学技术学院	佛山师范专科学校
佛山职业技术学院	佛山职工大学
重庆第二师范学院	涪陵教育学院
重庆第二师范学院	涪陵师范高等专科学校
重庆第二师范学院	涪陵师范学院
福州大学	福大
福建船政交通职业学院	福建船政学校
福建工程学院	福建建筑高等专科学校
福建船政交通职业学院	福建交通职业技术学院
福建船政交通职业学院	福建交院
福建农林大学	福建林学院
福建农林大学	福建农业大学
福建生物工程职业技术学院	福建生物工程职院
福建师范大学	福建师大
集美大学	福建体育学院
福建对外经济贸易职业技术学院	福建外经贸学院
莆田学院	福建医大莆田分校
福建工程学院	福建职业技术学院
福建中医药大学	福建中医学院
福建农林大学	福农大
福建师范大学	福师大
闽江学院	福州师范高等专科学校
福州外语外贸学院	福州外语外贸职业技术学院
福州职业技术学院	福州职院
抚顺职业技术学院	抚顺大学
抚顺师范高等专科学校	抚顺师专
辽宁石油化工大学	抚顺石油学院
抚顺职业技术学院	抚顺市电大
抚顺职业技术学院	抚顺市高等职业专科学校
抚顺师范高等专科学校	抚顺市教育学院
抚顺师范高等专科学校	抚顺师范专科学校
抚顺职业技术学院	抚顺职院
东华理工大学	抚州师范专科学校
莆田学院	莆田高等专科学校
莆田学院	莆田华侨体育师范学校
莆田学院	莆院
台湾辅仁大学	辅大
台湾辅仁大学	辅仁大学
复旦大学	复旦
盐城幼儿师范高等专科学校	阜宁高等师范学校
盐城幼儿师范高等专科学校	阜高师
阜新高等专科学校	阜新高专
阜新高等专科学校	阜新市教育学院
阜新高等专科学校	阜新师范专科学校
阜新高等专科学校	阜新市职工大学
甘肃农业大学	甘农大
兰州理工大学	甘肃工业大学
兰州文理学院	甘肃教育学院
兰州文理学院	甘肃联合大学
西北师范大学	甘肃省经济管理干部学院
兰州财经大学	甘肃省职工财经学院
甘肃中医药大学	甘肃中医学院
甘肃政法学院	甘政法
赣南师范大学	赣南师院
赣南师范大学	赣南师范学院
赣南师范大学科技学院	赣南师范学院科技学院
赣南医学院	赣医
香港大学	港大
武汉大学	葛洲坝水电工程学院
安徽公安职业学院	公安学院
中国人民公安大学	公大
西安工程大学	工程大
上海工商外国语职业学院	工商外国语
上海工商外国语职业学院	上海工商外国语学院
东莞理工学院	莞工
山东管理学院	管理学院
山东管理学院	山东省工会管理干部学院
广西财经学院	广财
广州大学	广大
华南理工大学	广东电力专科学校
广东职业技术学院	广东纺织职业技术学院
广东工业大学	广东工学院
广东开放大学	广东广播电视大学
广东海洋大学	广东海大
广东行政职业学院	广东行政学院
广东工业大学	广东机械学院
广东南方职业学院	广东江门艺华旅游职业学院
广东女子职业技术学院	广东女子学院
广东轻工职业技术学院	广东轻工
广东财经大学	广东商学院
广东石油化工学院	广东省茂名教育学院
广东石油化工学院	广东石油化工高等专科学校
广东司法警官职业学院	广东司法警院
广东体育职业技术学院	广东体育职院
广东省外语艺术职业学院	广东外语艺术学院
广东亚视演艺职业学院	广东亚视演艺职院
广东邮电职业技术学院	广东邮电学院
广东技术师范学院	广东职业技术师范学院
广东工贸职业技术学院	广工贸
广东海洋大学	广海
广州航海学院	广航高专
广州航海学院	航海高等专科学校
广州民航职业技术学院	广航职院
广东技术师范学院	广技师
广东金融学院	广金
广东警官学院	广警院
广东警官学院	广东警察学院
广东警官学院	广州警察学院
广东警官学院	广州警官学院
广州美术学院	广美
广东石油化工学院	广石化
广东水利电力职业技术学院	广水电职校
广州体育学院	广体
广东外语外贸大学	广外
广西财经学院	广西财政高等专科学校
广西广播电视大学	广西电大
南宁职业技术学院	广西电大南宁分校
广西国际商务职业技术学院	广西国商学院
广西民族大学	广西民大
广西民族大学	广西民族学院
广西大学	广西农学院
广西财经学院	广西商业高等专科学校
广西师范学院	广西师院
柳州职业技术学院	广西冶金工业职大
广西医科大学	广西医大
广西中医药大学	广西中医学院
广东食品药品职业学院	广药职院
广州医科大学	广医
广东石油化工学院	广油
辽宁广告职业学院	广院
广安职业技术学院	广职院
广州市广播电视大学	广州电大
广东外语外贸大学	广州对外贸易学院
广东外语外贸大学	广东财税专科学校
广东外语外贸大学	广州外国语学院
广州大学	广州纺织工业职工大学
广州大学	广州钢铁厂职工大学
广州大学	广州建筑总公司职工大学
广州大学	广州教育学院
广州大学	广州师范学院
广州大学	广州师范专科学校
广州大学	广州市城建职工大学
广州大学	广州市第二轻工业局职工大学
广州大学	广州市电子工业总公司职工大学
广州大学	广州市机电工业局职工大学
广州大学	广州市交通运输职工大学
广州大学	广州大学电信学院
广州大学	广州市轻工业局职工大学
广州体育职业技术学院	广州体育职院
广州大学	广州无线电厂职工大学
广州大学	广州市联合职工大学
广州医科大学	广州医学院
桂林电子科技大学	桂电
桂林航天工业学院	桂航
桂林航天工业学院	桂林航天工业高等专科学校
桂林师范高等专科学校	桂林地区教育学院
桂林师范高等专科学校	桂林市教育学院
桂林师范高等专科学校	桂林市师范学校
桂林电子科技大学	桂林电子工业学院
桂林理工大学	桂林工学院
桂林医学院	桂医
贵州大学	贵大
贵阳学院	贵阳金筑大学
贵阳学院	贵阳师范高等专科学校
贵州医科大学	贵阳医学院
贵州医科大学神奇民族医药学院	贵阳医学院神奇民族医药学院
贵州师范学院	贵阳职工大学
贵州师范学院	贵州教育学院
贵州师范学院	贵州师院
贵阳中医学院	贵中医
贵州财经大学	贵州财大
贵州财经大学	贵州财经学院
贵州广播电视大学	贵州电大
贵州警官职业学院	贵州公安管理干部学院
贵州警官职业学院	贵州人民警察职业技术学院
贵州警官职业学院	贵州政法管理干部学院
贵州大学	贵州工业大学
贵州财经大学	贵州计划管理干部学院
贵州大学	贵州建筑专科学校
贵州大学	贵州工学院
贵州工业职业技术学院	贵州科技工程职业学院
贵州民族大学	贵州民大
贵州民族大学	贵州民族学院
贵州大学	贵州农学院
贵州大学	贵州人民大学
贵州大学	贵州省经济管理干部学院
贵州大学	贵州省农业管理干部学院
贵州师范大学	贵州师大
贵州大学	贵州艺术高等专科学校
国防科学技术大学	国防科技大学
国际关系学院	国关
成都电子职工大学	国光电子管总厂职工大学
北京工业大学	国家建材局管理干部学院
扬州大学	国家税务局扬州培训中心
国家开放大学	国开大
国家开放大学	中国开放大学
国家开放大学	中央广播电视大学
国家开放大学	中央电大
国家开放大学	广播电视大学
暨南大学	国立暨南
中国美术学院	国美
中国戏曲学院	国戏
包头职业技术学院	国营内蒙古第一、第二机械制造厂职工大学
甘肃核工业职工大学	国营四0四厂职工大学
甘肃核工业职工大学	国营五0四厂职工大学
哈尔滨学院	哈尔滨大学
黑龙江财经学院	哈尔滨德强商务学院
哈尔滨理工大学	哈尔滨电工学院
哈尔滨航空职工大学	哈尔滨飞机制造公司职工工学院
黑龙江工程学院	哈尔滨工程高等专科学校
哈尔滨理工大学	哈尔滨工业高等专科学校
哈尔滨信息工程学院	哈尔滨华夏计算机学院
哈尔滨信息工程学院	哈尔滨华夏计算机职业技术学院
哈尔滨工业大学	哈尔滨建筑大学
哈尔滨理工大学	哈尔滨科技大学
哈尔滨学院	哈尔滨师范学校
哈尔滨学院	哈尔滨师范专科学校
哈尔滨学院	哈尔滨市成人教育学院
哈尔滨学院	哈尔滨市教育学院
哈尔滨工程大学	哈工程
哈尔滨工业大学	哈工大
哈尔滨商业大学	哈商大
哈尔滨师范大学	哈师大
哈尔滨体育学院	哈体院
哈尔滨铁道职业技术学院	哈铁学院
哈尔滨医科大学	哈医大
三亚航空旅游职业学院	海航学院
海南经贸职业技术学院	海经贸
公安海警学院	海警学院
公安海警学院	公安海警高等专科学校
呼伦贝尔学院	海拉尔师范专科学校
海南师范大学	海南师范学院
海南工商职业学院	海南万和信息职业技术学院
海南师范大学	海师
海南医学院	海医
浙江国际海运职业技术学院	海运学院
海南政法职业学院	海政
邯郸职业技术学院	邯大
邯郸职业技术学院	邯郸大学
邯郸学院	邯郸地区教育学院
邯郸学院	邯郸师范专科学校
河北工程大学	邯郸农业高等专科学校
邯郸学院	邯郸市教育学院
河北工程大学	邯郸医学高等专科学校
韩山师范学院	韩山师院
陕西理工学院	汉中师范学院
杭州电子科技大学	杭电
杭州师范大学	杭师
浙江大学	杭州大学
杭州电子科技大学	杭州电子工业学院
杭州师范大学	杭州师范学院
杭州师范大学	杭州医学高等专科学校
合肥学院	合肥教育学院
合肥学院	合肥联合大学
合肥学院	合肥师范学校
合肥学院	合肥外语专科学校
合肥工业大学	合工大
合肥学院	合联大
合肥师范学院	合师
合肥学院	合院
河北北方学院	河北北院
河北经贸大学	河北财经学院
河北广播电视大学	河北电大
河北科技大学	河北纺织职工大学
河北工程大学	河北工程学院
河北水利电力学院	河北工专
河北水利电力学院	河北工程技术高等专科学校
河北化工医药职业技术学院	河北化工医药学院
河北科技大学	河北机电学院
河北工程大学	河北建筑科技学院
河北师范大学	河北教育学院
河北金融学院	河北金融
河北经贸大学	河北经贸学院
河北科技师范学院	河北科师
华北理工大学	河北理工学院
华北理工大学	河北理工大学
华北理工大学	河北联大
华北理工大学	华北煤炭医学院
河北农业大学	河北林学院
河北旅游职业学院	河北旅院
河北能源职业技术学院	河北能源
河北农业大学	河北农大
河北科技师范学院	河北农业技术师范学院
河北科技大学	河北轻化工学院
河北经贸大学	河北商业高等专科学校
河北师范大学	河北师大
河北师范大学	河北师范学院
河北司法警官职业学院	河北司法警院
河北对外经贸职业学院	河北外国语职院
河北对外经贸职业学院	河北外国语职业学院
河北对外经贸职业学院	秦皇岛外国语职业学院
河北医科大学	河北医大
河北医科大学	河北医学院
河北科技师范学院	河北职业技术师范学院
河北医科大学	河北中医学院
广西现代职业技术学院	河池职业学院
河海大学	河海
河南科技大学	河科大
河南科技学院	河科院
河南理工大学	河理工
河南财经政法大学	huel
河南财经政法大学	河南财大
河南财经政法大学	河南财大
河南广播电视大学	河南财经学院
河南工学院	河南机电高专
河南工学院	河南机专
河南工学院	河南机电高等专科学校
河南警察学院	河南警院
河南警察学院	河南公安高等专科学校
河南农业大学	河南农大
郑州大学	河南体专
郑州大学	河南医科大学
河南科技学院	河南职业技术师范学院
河南职业技术学院	河南职院
河南师范大学	河师大
河北外国语学院	河外
河北外国语学院	石家庄外语翻译职业学院
河南中医药大学	河中医
河南中医药大学	河南中医学院
鹤岗师范高等专科学校	鹤岗师专
黑龙江工程学院	黑工程
黑龙江科技大学	黑科大
哈尔滨江南职业技术学院	黑龙江北开职业技术学院
哈尔滨商业大学	黑龙江财政专科学校
黑龙江职业学院	黑龙江畜牧兽医职业学院
黑龙江职业学院	黑龙江工商职业技术学院
黑龙江建筑职业技术学院	黑龙江建筑职院
黑龙江工程学院	黑龙江交通高等专科学校
黑龙江公安警官职业学院	黑龙江警院
黑龙江科技大学	黑龙江科技学院
黑龙江农业工程职业学院	黑龙江农工职院
黑龙江农垦科技职业学院	黑龙江农垦林业职业技术学院
黑龙江农垦科技职业学院	黑龙江农垦农业职业技术学院
哈尔滨师范大学	黑龙江农垦师范专科学校
黑龙江农垦职业学院	黑龙江农垦职院
哈尔滨商业大学	黑龙江商学院
黑龙江生态工程职业学院	黑龙江生态工程职院
东北农业大学	黑龙江省农业管理干部学院
哈尔滨师范大学	黑龙江省物资学校
哈尔滨师范大学	黑龙江省物资职工大学
黑龙江大学	黑龙江水利专科学校
黑龙江信息技术职业学院	黑龙江信息学院
黑龙江艺术职业学院	黑龙江艺术学院
黑龙江幼儿师范高等专科学校	黑龙江幼专
衡水学院	衡水师范专科学校
衡水职业技术学院	衡水职院
衡阳师范学院	衡阳教育学院
衡阳师范学院	衡阳师范高等专科学校
南华大学	衡阳医学院
衡水学院	衡院
红河学院	红院
哈尔滨师范大学	呼兰师范专科学校
呼伦贝尔学院	呼伦贝尔管理干部学院
武汉纺织大学	湖北财专
武汉纺织大学	湖北财经高等专科学校
湖北城市建设职业技术学院	湖北城建职院
湖北大学	湖北大
湖北广播电视大学	湖北电大
湖北第二师范学院	湖北二师
湖北工业大学	湖北工学院
湖北工业职业技术学院	十堰职业大学
湖北工业职业技术学院	湖北工业职院
湖北工业职业技术学院	十堰职业技术学院
湖北理工学院	湖北理工
湖北民族学院	湖北民院
长江大学	湖北农学院
三峡大学	湖北三峡学院
湖北经济学院	湖北商业高等专科学校
华中师范大学	湖北省供销合作学校
湖北经济学院	湖北省计划管理干部学院
长江大学	湖北省卫生职工医学院
湖北师范大学	湖北师院
湖北师范大学	湖北师大
湖北师范大学	湖北师范学院
湖北师范大学文理学院	湖北师范学院文理学院
湖北中医药大学	湖北药检高等专科学校
湖北医药学院	湖北医药
湖北中医药大学	湖北中医学院
湖北工程学院	湖工程
湖北工业大学	湖工大
湖北经济学院	湖经
湖北警官学院	湖警
湖北科技学院	湖科院
湖北美术学院	湖美
湖南大学	湖南财经学院
湖南财政经济学院	湖南财院
湖南财政经济学院	湖南财经高等专科学校
湖南城市学院	湖南城建高等专科学校
湖南城建职业技术学院	湖南城建职院
湖南城市学院	湖南城院
湖南广播电视大学	湖南电大
湖南外贸职业学院	湖南对外经济贸易职业学院
长沙师范学院	湖南儿童工程职业学院
长沙师范学院	长沙师范高等专科学校
湖南工程学院	湖南纺织高等专科学校
湖南工业大学	湖南工大
湖南大学	湖南计算机高等专科学校
湖南高速铁路职业技术学院	湖南交通工程职业技术学院
湖南师范大学	湖南教育学院
湖南警察学院	湖南警院
湖南警察学院	湖南公安高等专科学校
湖南农业大学	湖南农大
长沙理工大学	湖南轻工业高等专科学校
湖南商务职业技术学院	湖南商务职院
湖南商学院	湖南商业专科学校
湖南石油化工职业技术学院	湖南省化工职工大学
湖南石油化工职业技术学院	长岭炼油厂职工大学
湖南石油化工职业技术学院	长沙市化工局职工大学
湖南石油化工职业技术学院	湖南石化职工大学
湖南商学院	湖南省商业管理干部学院
湖南师范大学	湖南省政法管理干部学院
湖南理工职业技术学院	湖南省资兴矿务局职工大学
湖南理工职业技术学院	湖南省涟邵矿务局职工大学
湖南理工职业技术学院	湖南煤炭职工大学
湖南理工职业技术学院	湖南工业职工大学
湖南师范大学	湖南师大
湖南文理学院	湖南文理
湖南信息职业技术学院	湖南信息职业学院
湖南冶金职业技术学院	湖南冶金职院
中南大学	湖南医科大学
湖南师范大学	湖南医学高等专科学校
湖南中医药大学	湖南中医学院
湖南商学院	湖商
湖州师范学院求真学院	湖师求真学院
湖南中医药大学	湖中大
湖北中医药大学	湖中医
湖州师范学院	湖州教师进修学院
湖州师范学院	湖州师范
湖州师范学院	湖州师范学校
湖州师范学院	湖州师范专科学校
湖州职业技术学院	湖州职院
华北电力大学	华北电力学院
华北理工大学	河北联合大学
安徽理工大学	华北煤炭医学高等专科学校
安徽理工大学	淮南矿业学院
北京工业大学	华北水利水电学院北京研究生部
华北水利水电大学	华北水利水电学院
华侨大学	华大
华北电力大学	华电
江苏科技大学	华东船舶工业学院
东华理工大学	华东地质学院
上海理工大学	华东工业大学
华东交通大学	华东交大
华东理工大学	华东理工
华东师范大学	华东师大
安徽工业大学	华东冶金学院
华东政法大学	华东政法
华东政法大学	华东政法学院
华南理工大学	华工大
北华航天工业学院	华航
华北科技学院	华科
华东理工大学	华理
广东工业大学	华南建设学院(东院)
华南理工大学广州学院	华南理工大学广州汽车学院
华南师范大学	华南师大
华南农业大学	华农大
华东师范大学	华师大
华中师范大学	华师
华北水利水电大学	华水
吉林华桥外国语学院	华外
吉林华桥外国语学院	华桥外院
吉林华桥外国语学院	吉林华侨外国语学院
河北地质大学华信学院	石家庄经济学院华信学院
华东政法大学	华政
华中科技大学	华中大
华中科技大学	华中理工大学
华中农业大学	华中农大
华中师范大学	华中师大
怀化广播电视大学	怀化电大
湖南医药学院	怀化医专
湖南医药学院	怀化医学高等专科学校
淮北职业技术学院	淮北教育学院
淮北职业技术学院	淮北矿务局职工大学
淮北师范大学	淮北煤炭师范学院
淮北职业技术学院	淮北职院
山西兵器工业职工大学	淮海机械厂职工大学
安徽理工大学	淮南工业学院
淮南师范学院	淮南教育学院
淮南联合大学	淮南联大
淮南师范学院	淮南师范学校
淮南师范学院	淮南师范专科学校
淮北师范大学	淮师大
淮北师范大学	淮师
淮阴工学院	淮阴工业专科学校
淮阴师范学院	淮阴教育学院
淮阴师范学院	淮阴师范专科学校
淮阴工学院	淮阴市机械工业职工大学
淮南职业技术学院	淮职
黄冈师范学院	黄冈师院
黄冈职业技术学院	黄冈职院
郑州大学	黄河大学
黄河科技学院	黄河科技
黄淮学院	黄淮
黄石广播电视大学	黄石电大
湖北理工学院	黄石高等专科学校
湖北理工学院	黄石教育学院
湖北理工学院	黄石理工学院
山西兵器工业职工大学	惠丰机械厂职工工学院
惠州学院	惠阳师范专科学校
惠州学院	惠州教育学院
北京工商大学	机械工业管理干部学院
哈尔滨医科大学	鸡西煤炭医学高等专科学校
衡阳师范学院	即衡阳市教师进修学院
井冈山大学	吉安教育学院
井冈山大学	吉安师范专科学校
吉林大学	吉大
吉林动画学院	jai
吉林动画学院	吉动
吉林动画学院	吉林艺术学院动画学院
吉林财经大学	吉林财大
吉林广播电视大学	吉林电大
北华大学	吉林电气化高等专科学校
吉林电子信息职业技术学院	吉林电信学院
吉林工商学院	吉林工商
长春理工大学	吉林工学院
吉林大学	吉林工业大学
吉林化工学院	吉林化工
吉林工程技术师范学院	吉林技师
吉林建筑大学	吉林建大
吉林建筑大学	吉林建工
吉林建筑大学	吉林建筑工程学院
吉林交通职业技术学院	吉林交职院
吉林警察学院	吉林警院
吉林警察学院	吉林公安高等专科学校
北华大学	吉林林学院
吉林农业大学	吉林农大
吉林农业科技学院	吉林农科
吉林农业科技学院	吉林农垦特产高等专科学校
吉林农业科技学院	吉林特产高等专科学校
吉林工程职业学院	吉林农业工程学院
吉林工程职业学院	吉林农业工程职业技术学院
长春中医药大学	吉林省卫生管理干部学院
吉林省行政管理干部学院	吉林省宣传文化管理干部学院
吉林省行政管理干部学院	吉林省政法管理干部学院
吉林师范大学	吉林师大
北华大学	吉林师范学院
北华大学	吉林医学院
吉林医药学院	吉林医药
延边大学	吉林艺术学院延边分院
吉林工程技术师范学院	吉林职业师范学院
吉林艺术学院	吉艺
集美大学	集大
集美大学	集美财经高等专科学校
集美大学	集美航海学院
集美大学	集美师范专科学校
暨南大学	暨大
济南大学	济大
山东交通学院	济南交通高等专科学校
济南大学	济南联合大学
山东职业学院	济南铁道职业技术学院
济宁医学院	济医
济宁学院	济院
佳木斯大学	佳大
佳木斯大学	佳木斯工学院
佳木斯大学	佳木斯师范专科学校
佳木斯大学	佳木斯医学院
重庆机电职业技术学院	嘉陵机器厂职工大学
嘉兴广播电视大学	嘉兴电大
嘉兴学院	嘉兴高等专科学校
嘉应学院	嘉应大学
嘉应学院	嘉应教育学院
嘉应学院	嘉应师范专科学校
上海建桥学院	建桥
重庆机电职业技术学院	建设机床厂职工大学
江西中医药大学科技学院	江西中医学院科技学院
江西财经大学	江财
江西服装学院	江服
江西服装学院	江西服装职业技术学院
长江大学	江汉石油学院
江汉艺术职业学院	江汉艺院
江苏理工学院	江理工
江西理工大学	江理
重庆机电职业技术学院	江陵机器厂职工大学
湖南国防工业职业技术学院	江麓机械厂职工大学
湖南国防工业职业技术学院	江南机器厂职工工学院
湖南国防工业职业技术学院	沅江兵工联合职工大学
湖南国防工业职业技术学院	湖南科技工业职业技术学院
安徽工程大学	江南理工大学
安徽工程大学	安徽工程学院
江南大学	江南学院
南京财经大学	江苏财经高等专科学校
南京财经大学	江苏经济管理干部学院
南京财经大学	南京经济学院
常州大学	江苏工业学院
江苏开放大学	江苏广播电视大学
江苏海事职业技术学院	江苏海院
江苏理工学院	江苏技术师范学院
江苏建筑职业技术学院	江苏建筑学院
江苏大学	江苏理工大学
扬州大学	江苏农学院
扬州大学	江苏商业专科学校
江苏商贸职业学院	江苏商院
江苏商贸职业学院	南通商贸高等职业学校
镇江市高等专科学校	江苏省广播电视大学镇江分校
淮阴工学院	江苏省农垦职工大学
中国药科大学	江苏省药科学校
江苏师范大学	江苏师大
常州大学	江苏石油化工学院
扬州大学	江苏水利工程专科学校
江西财经大学	江西财大
江西财经大学	江西财经管理干部学院
江西财经大学	江西财经学院
南昌大学	江西大学
南昌职业学院	江西大宇职业技术学院
江西冶金职业技术学院	江西钢厂职工大学
江西冶金职业技术学院	江西新余钢铁总厂职工大学
南昌大学	江西工业大学
江西卫生职业学院	江西护理学院
江西卫生职业学院	江西卫院
江西卫生职业学院	江西护理职业技术学院
江西建设职业技术学院	江西建院
江西经济管理干部学院	江西经管院
江西警察学院	江西警院
江西警察学院	江西公安专科学校
江西科技师范大学	江西科大
江西科技师范大学	科技师大
江西科技师范大学	南昌科技大学
江西科技师范大学	江西科技师范学院
江西科技学院	江西蓝天学院
江西理工大学	江西理工
江西旅游商贸职业学院	江西旅商学院
江西工业职业技术学院	江西轻工职业技术学院
江西工业职业技术学院	江西省纺织工业职工大学
江西工业职业技术学院	江西省国防工业职工大学
江西外语外贸职业学院	江西外语外贸
南昌大学	江西医学院
江西中医药高等专科学校	江西医专
江西制造职业技术学院	江西制造学院
江西新能源科技职业学院	江西中山职业技术学院
江西新能源科技职业学院	江西太阳能科技职业学院
江西中医药大学	江西中医学院
上海交通大学	交通大学
山东交通学院	交通学院
宁夏大学	教育学院
呼伦贝尔学院	教院呼伦贝尔盟教育学院
河南理工大学	焦作工学院
金陵科技学院	金陵职业大学
金陵科技学院	金陵科技大学
上海立信会计金融学院	金融学院
上海立信会计金融学院	上海金融学院
上海立信会计金融学院	上海立信会计学院
长春金融高等专科学校	金专
辽宁理工职业学院	锦州商务职业学院
锦州师范高等专科学校	锦州师专
锦州师范高等专科学校	锦州市教育学院
锦州师范高等专科学校	锦州师范专科学校
锦州医科大学	锦州医学院
锦州医科大学	辽宁医学院
锦州医科大学	辽医
锦州医科大学医疗学院	锦州医学院医疗学院
锦州医科大学医疗学院	辽宁医学院医疗学院
锦州医科大学医疗学院	辽宁医科大学医疗学院
锦州师范高等专科学校	锦州职工大学
山西兵器工业职工大学	晋安化工厂职工大学
山西兵器工业职工大学	晋西机器厂职工大学
晋中师范高等专科学校	晋中地区教育学院
晋中师范高等专科学校	晋中师范专科学校
河北经贸大学	经贸大
河南经贸职业学院	经贸学院
湖北经济学院	经院
荆楚理工学院	荆楚理工
荆楚理工学院	荆门职业大学
荆楚理工学院	荆门职业技术学院
荆楚理工学院	沙洋师范高等专科学校
长江大学文理学院	荆州教育学院
长江大学文理学院	荆州师范高等专科学校
荆州理工职业学院	荆州理工
荆州理工职业学院	沙市大学
长江大学文理学院	荆州师范学院
井冈山大学	井大
井冈山大学	井冈山师范学院
井冈山大学	井冈山学院
井冈山大学	井冈山医学高等专科学校
井冈山大学	井冈山职业技术学院
景德镇陶瓷大学	景陶
景德镇陶瓷大学科技艺术学院	景德镇陶瓷学院科技艺术学院
九江学院	九江财经高等专科学校
九江广播电视大学	九江电大
九江学院	九江教育学院
九江学院	九江师范专科学校
九江学院	九江医学专科学校
青岛酒店管理职业技术学院	青岛酒店管理学院
江苏农林职业技术学院	句容农校
吉林大学	军需大学
邢台职业技术学院	军需学院
喀什大学	喀师
喀什大学	喀什师范学院
开封大学	开大
河南大学	开封师范高等专科学校
河南大学	开封医学高等专科学校
南京工程学院康尼学院	康尼学院
湖北科技职业学院	科技职院
齐齐哈尔高等师范专科学校	克山师范专科学校
黑龙江八一农垦大学	垦区黄埔
中国矿业大学	矿大北京
中国矿业大学	矿大
昆明理工大学	昆工
昆明医科大学	昆明医学院
昆明医科大学	昆医大
青岛农业大学	莱阳农学院
兰州城市学院	兰城院
兰州大学	兰大
兰州财经大学	兰商
兰州交通大学	兰州交大
兰州理工大学	兰州理工
兰州财经大学	兰州商学院
兰州财经大学长青学院	兰州商学院长青学院
兰州财经大学陇桥学院	兰州商学院陇桥学院
甘肃机电职业技术学院	兰州石化机器厂职工大学
甘肃机电职业技术学院	甘肃长城电器工业公司职工大学
甘肃机电职业技术学院	国营长风机器厂职工大学
甘肃机电职业技术学院	兰州通用机器厂职工大学
甘肃机电职业技术学院	甘肃机械电子职工大学
兰州交通大学	兰州铁道学院
兰州大学	兰州医学院
廊坊师范学院	廊坊教育学院
廊坊师范学院	廊坊师范学校
廊坊师范学院	廊坊师范专科学校
乐山师范学院	乐山教育学院
乐山师范学院	乐山师范高等专科学校
乐山师范学院	乐山师院
漯河医学高等专科学校	漯河医专
黎明职业大学	黎大
黎明职业大学	黎明大学
香港理工大学	理大
山东理工大学	理工大
大连大学	连大
淮海工学院	连云港化工高等专科学校
连云港职业技术学院	连云港市职业技术教育中心
连云港职业技术学院	连云港市职业技术学院
连云港职业技术学院	连云港职业大学
西昌学院	凉山大学
西昌学院	凉山教育学院
中国计量大学	量院
中国计量大学	中国计量学院
聊城大学	聊城师范学院
聊城大学	聊大
辽宁工程技术大学	辽工大
辽宁科技大学	辽科大
辽宁科技学院	辽科院
辽东学院	辽宁财政高等专科学校
辽宁广播电视大学	辽宁电大
辽宁工程技术大学	辽宁工大
辽宁工业大学	辽宁工学院
沈阳音乐学院	辽宁工运学院
沈阳建筑大学	辽宁建设职工大学
辽宁省交通高等专科学校	辽宁交专
沈阳师范大学	辽宁教育学院
辽宁传媒学院	辽宁美院
辽宁传媒学院	辽宁美术职业学院
沈阳工程学院	辽宁商务职业学院
渤海大学	渤大
渤海大学	辽宁商业高等专科学校
渤海大学	锦州师范学院
辽宁大学	辽宁外国语师范高等专科学校
辽宁对外经贸学院	辽宁外经贸
辽宁中医药大学	辽宁卫生职工医学院
辽宁中医药大学	辽宁中医学院
辽宁中医药大学	辽宁中医大学
辽宁农业职业技术学院	辽宁熊岳农业高等专科学校
辽宁装备制造职业技术学院	辽宁装备制造学院
辽宁师范大学	辽师大
辽宁师范大学	辽师
辽阳职业技术学院	辽阳大学
辽阳职业技术学院	辽阳师范专科学校
辽阳职业技术学院	辽阳师教育学院
沈阳工业大学	辽阳石油化工高等专科学校
辽阳职业技术学院	辽阳职院
辽宁中医药大学	辽中医
临沂大学	临大
山西师范大学	临汾师范专科学校
临沂大学	临沂教育学院
临沂大学	临沂师范学院
临沂大学	临沂师范专科学校
山东医学高等专科学校	临沂医学专科学校
中南林业科技大学	林科大
东北林业大学	林业大学
福建林业职业技术学院	林职院
湖南科技学院	零陵学院
柳州城市职业学院	柳州城市学院
柳州职业技术学院	柳州市工业职大
柳州职业技术学院	柳州市机电职大
柳州职业技术学院	柳州市教育学院
柳州职业技术学院	柳州市职大
柳州铁道职业技术学院	柳州运输职业技术学院
皖西学院	六安师范学校
皖西学院	六安师范专科学校
西安航空职工大学	六三零研究所职工工学院
闽西职业技术学院	龙岩市工业学校
闽西职业技术学院	闵西职业技术学院
闽西职业技术学院	闵西职业大学
陇南师范高等专科学校	陇南师专
西南医科大学	泸医
重庆机电职业技术学院	泸州化工厂职工大学
四川化工职业技术学院	泸州化专
西南医科大学	泸州医学院
鲁东大学	鲁大
山东经贸职业学院	鲁经院
鲁迅美术学院	鲁美
山西煤炭职工联合大学	潞安矿务局职工大学
河南科技大学	洛阳工学院
洛阳师范学院	洛阳教育学院
洛阳理工学院	洛阳理工
河南科技大学	洛阳农业高等专科学校
洛阳师范学院	洛阳师范高等专科学校
河南科技大学	洛阳医学高等专科学校
吕梁学院	吕院
吕梁学院	吕梁高等专科学校
桂林旅游学院	桂林旅游高等专科学校
广东石油化工学院	茂名石油工业公司职工大学
广东石油化工学院	茂名学院
茂名职业技术学院	茂名职院
对外经济贸易大学	贸大
湄洲湾职业技术学院	湄洲职院
红河学院	蒙自师范高等专科学校
绵阳师范学院	绵师
西南科技大学	绵阳经济技术高等专科学校
绵阳师范学院	绵阳师院
黄淮学院	民办中原职业技术学院
大连民族大学	大连民族学院
大连民族大学	大连民大
宁德师范学院	闽东职业大学
宁德师范学院	宁德师范专科学校
福建工程学院	闽工院
闽江学院	闽江职业大学
闽南师范大学	闽南师大
福建农林大学	闽农大
闽江学院	闽院
闽江学院	闽江大学
闽北职业技术学院	闽职院
牡丹江大学	牡大mu
牡丹江师范学院	牡师
牡丹江医学院	牡医
南京财经大学	南财
江西科技师范大学	南昌高等专科学校
南昌航空大学	南昌航空工业学院
南昌师范高等专科学校	南昌师专
江西工业职业技术学院	南昌无线电工业学校
南充职业技术学院	南充工校
南充职业技术学院	南充工业学校
南充职业技术学院	南充教育学院
南充职业技术学院	南充农业学校
南充职业技术学院	四川省水利经济管理学校
南京大学	南大
江西理工大学	南方冶金学院
南京工业大学	南工nanjingtech
南京工程学院	南工程
南京工业大学	南工大njut
南阳理工学院	南工
南京工业职业技术学院	南工院
成都电子职工大学	南光机器厂职工大学
南海广播电视大学	南海电大
广东东软学院	南海东软
广东东软学院	南海东软信息技术职业学院
南京航空航天大学	南航
湖南理工学院南湖学院	南湖学院
南华大学	南华
南京科技职业学院	南化院
南京科技职业学院	南科院
南京科技职业学院	南京化工职业技术学院
南京交通职业技术学院	南交院
南京工程学院	南京电力高等专科学校
南京工业大学	南京化工大学
南京工程学院	南京机械高等专科学校
南京工业大学	南京建筑工程学院
东南大学	南京交通高等专科学校
南京晓庄学院	南京教育学院
南京审计大学	南京金融高等专科学校
金陵科技学院	南京农业专科学校
南京信息工程大学	南京气象学院
南京审计大学	南京审计学院
南京审计大学	南审
南京晓庄学院	南京师范专科学校
南京晓庄学院	南京市晓庄师范学校
东南大学	南京铁道医学院
南京邮电大学	南京邮电学院
南开大学	南开
南京理工大学	南理工
南昌理工学院	南理
南京林业大学	南林大
南京林业大学	南林
南宁职业技术学院	南宁市教育学院
南宁职业技术学院	南宁职业大学
南京农业大学	南农大
南京农业大学	南农
南京理工大学	南炮工
武夷学院	南平职业大学
武夷学院	南平师范专科学校
南京审计大学	南审
南京师范大学	南师大
南京视觉艺术职业学院	南视觉
南京视觉艺术职业学院	南京视觉艺术学院
南京体育学院	南体
南通师范高等专科学校	南通高师
南通师范高等专科学校	南通高等师范学校
南通大学	南通工学院
南通职业大学	南通工业管理干部学院
南通职业大学	南通市职工大学
南通航运职业技术学院	南通航院
南通大学	南通教育学院
南通大学	南通师范学院
南通大学	南通师范专科学校
南通大学	南通医学院
南通科技职业学院	南通科院
南通科技职业学院	南通农业职业技术学院
南京信息工程大学	南信大
南阳师范学院	南阳教育学院
南阳师范学院	南阳师范高等专科学校
南阳师范学院	南阳师院
南方医科大学	南医大
南京艺术学院	南艺
南京邮电大学	南邮
南宁学院	南院
南宁学院	邕江大学
南昌市职工科技大学	南职科大
南京中医药大学	南中医
内蒙古大学	内大
内蒙古工业大学	内工大
内江广播电视大学	内江电大
内江师范学院	内江教育学院
内江师范学院	内江师范高等专科学校
内江师范学院	内江师院
内蒙古交通职业技术学院	内交职院
内蒙古科技大学	内科大
内蒙古北方职业技术学院	内蒙古北方职院
内蒙古财经大学	内蒙古财经学院
呼伦贝尔学院	内蒙古电大呼伦贝尔分校
内蒙古广播电视大学	内蒙古电大
内蒙古丰州职业学院	内蒙古丰州职院
赤峰学院	内蒙古广播电视大学赤峰分校
内蒙古机电职业技术学院	内蒙古机电学院
内蒙古师范大学	内蒙古教育学院
内蒙古警察职业学院	内蒙古警院
内蒙古农业大学	内蒙古林学院
内蒙古民族大学	内蒙古蒙医学院
内蒙古民族大学	内蒙古民族师范学院
内蒙古农业大学	内蒙古农牧学院
内蒙古工业职业学院	内蒙古轩元职业学院
内蒙古医科大学	内蒙古医学院
内蒙古建筑职业技术学院	内蒙建院
内蒙古农业大学	内农大
内蒙古师范大学	内师大
内蒙古医科大学	内医大
内江职业技术学院	内职院
宁波大学	宁波师范学院
宁波卫生职业技术学院	宁波天一职业技术学院
宁德师范学院	ndnu
宁德师范学院	宁德师院
宁德师范学院	宁德师范高等专科学校
宁波工程学院	宁工院
宁夏大学	宁夏工学院
宁夏职业技术学院	宁夏广播电视大学
宁夏职业技术学院	宁夏机械技工学校
宁夏大学	宁夏农学院
宁夏师范学院	宁夏师院
宁夏医科大学	宁夏医学院
宁夏职业技术学院	宁夏职工科技学院
宁夏职业技术学院	宁夏重工业职工大学
宁夏医科大学	宁医大
安徽农业大学	农大
福建农林大学	农林大
中华女子学院	女院
河北女子职业技术学院	女子学院
西安欧亚学院	欧亚学院
攀枝花学院	攀大
西安培华学院	培华学院
广东培正学院	培正
徐州工程学院	彭城职业大学
甘肃医学院	平凉医学高等专科学校
甘肃医学院	平凉卫生学校
平顶山学院	平院
七台河职业学院	七台河职院
齐齐哈尔工程学院	齐工程
齐齐哈尔工程学院	齐齐哈尔职业学院
齐鲁工业大学	齐工大
齐鲁师范学院	齐鲁师院
齐鲁师范学院	山东教育学院
齐齐哈尔大学	齐齐哈尔轻工学院
齐齐哈尔大学	齐齐哈尔师范学院
齐齐哈尔高等师范专科学校	齐齐哈尔师专
齐齐哈尔高等师范专科学校	齐齐哈尔师范高等专科学校
齐齐哈尔医学院	齐医
湖北汽车工业学院	汽工学院
成都电子职工大学	前锋无线电仪器厂职工大学
黔东南民族职业技术学院	黔东南职院
黔南民族师范学院	黔南民族师范高等专科学校
黔南民族医学高等专科学校	黔南医专
黔南民族职业技术学院	黔南职院
黔南民族师范学院	黔南州教育学院
黔西南民族职业技术学院	黔西南职院
秦皇岛职业技术学院	秦皇岛职院
清华大学	清华
清远职业技术学院	清职院
中国海洋大学	青岛海洋大学
青岛科技大学	青岛化工学院
青岛理工大学	青岛建筑工程学院
青岛职业技术学院	青岛教育学院
青岛科技大学	青岛科大
青岛理工大学	青岛理工
青岛农业大学	青岛农大
青岛大学	青岛师范专科学校
青岛理工大学	青岛冶金矿山职工大学
青岛大学	青岛医学院
青海大学	青海畜牧兽医学院
青海省联合职工大学	青海地质职工专科学校
青海省联合职工大学	青海建筑职工专科学校
青海师范大学	青海教育学院
青海民族大学	青海民大
青海民族大学	青海民族学院
青海师范大学	青海师大
青海省联合职工大学	青海卫生职工专科学校
青海大学	青海医学院
青海省联合职工大学	青海重型机床厂职工大学
青岛科技大学	青科
辽宁兵器工业职工大学	庆阳化工厂职工大学
琼台师范学院	琼台师范高等专科学校
重庆三峡学院	区工交职工中专学校
曲靖师范学院	曲靖教育学院
曲靖师范学院	曲靖师范高等专科学校
曲靖师范学院	曲靖师范学校
曲阜师范大学	曲师大
泉州师范学院	泉州师院
中国人民大学	人大
日照职业技术学院	日职
三峡大学	三大
三江学院	三江
三江学院	三江大学
三明学院	三明师范高等专科学校
三明学院	三明师范学校
三明学院	三明市教师进修学校
三明学院	三明职业大学
三明学院	三明高等专科学校
重庆三峡医药高等专科学校	三峡医专
湖北三峡职业技术学院	三峡职院
三亚城市职业学院	三亚城市学院
上海杉达学院	杉达学院
上海杉达学院	杉达大学
荆州理工职业学院	沙市职业大学
厦门大学	厦大
厦门理工学院	厦理
厦门理工学院	厦门理工
集美大学	厦门水产学院
厦门理工学院	厦软
厦门理工学院	厦门软件学院
青岛大学	山东纺织工学院
山东理工大学	山东工程学院
山东大学	山东工业大学
山东华宇工学院	山东华宇学院
山东华宇工学院	山东华宇职业技术学院
山东理工大学	山东建材工业学院淄博分校
济南大学	山东建筑材料工业学院
山东建筑大学	山东建筑工程学院
山东警察学院	山东警院
山东科技大学	山东科大
山东科技大学	山东矿业学院
山东理工大学	山东理工
山东科技大学	山东煤炭教育学院
齐鲁工业大学	山东轻工业学院
山东理工大学	山东省广播电视大学淄博分校
山东水利职业学院	山东水利职院
齐鲁医药学院	山东万杰医学院
齐鲁医药学院	万杰医学院
山东大学	山东医科大学
山东中医药大学	山东中医大
山东工商学院	山工商
山东工艺美术学院	山工艺
山东建筑大学	山建工
山东农业大学	山农
山东青年政治学院	山青
山东青年政治学院	山东省青年管理干部学院
山东师范大学	山师
山东体育学院	山体
山西财经大学	山西财大
山西财经大学	山西财经学院
太原师范学院	山西大学师范学院
山西工商学院	山西工商
山西工商学院	山西工商职业学院
山西大同大学	山西工业职业技术学院
山西兵器工业职工大学	山西机床厂职工工学院
山西机电职工学院	山西机械职工大学
山西财经大学	山西经济管理学院
太原理工大学	山西矿业学院
山西大同大学	山西矿业职业技术学院
山西农业大学	山西农大
山西运城农业职业技术学院	山西农大运城农学院
山西运城农业职业技术学院	运城农业职业技术学院
山西药科职业学院	山西生物应用职业技术学院
太原师范学院	山西省教育学院
山西师范大学	山西省职业师范专科学校
山西师范大学	山西师大
山西同文职业技术学院	山西同文外语职业学院
山西药科职业学院	山西药校
山西中医学院	山西中医
山西职业技术学院	山西综合职业技术学院
山东信息职业技术学院	山信大
山西信息职业技术学院	山信
山西医科大学	山医大
山东艺术学院	山艺
山东政法学院	山政
陕西理工学院	陕工院
陕西工业职业技术学院	陕工职院
陕西科技大学	陕科大
陕西理工学院	陕理工
陕西青年职业学院	陕青院
陕西师范大学	陕师大
西安交通大学	陕西财经学院
西安财经学院	陕西财政专科学校
陕西工商职业学院	陕西纺织服装职业技术学院
西安航空职工大学	陕西飞机制造公司职工工学院
陕西理工学院	陕西工学院
西安航空职工大学	陕西航空工业职工大学
西安财经学院	陕西经贸学院
西安财经学院	陕西商业专科学校
西北农林科技大学	陕西省林业科学研究院
西北农林科技大学	陕西省农业科学院
西安外国语大学	陕西省外国语师范专科学校
西北农林科技大学	陕西省西北植物研究所
陕西中医药大学	陕西中医学院
陕西邮电职业技术学院	陕邮职院
陕西职业技术学院	陕职院
陕西中医药大学	陕中医院
汕头大学	汕大
汕头职业技术学院	汕头职院
哈尔滨商业大学	商大
商丘师范学院	商丘教育学院
商丘师范学院	商丘师范高等专科学校
商丘医学高等专科学校	商丘医专
商丘职业技术学院	商丘职院
商丘师范学院	商师
山东商务职业学院	商院
山东商业职业技术学院	商职
上海财经大学	上财
上海大学	上大
上海商学院	上海财贸管理干部学院
上海商学院	上海商业职业技术学院
同济大学	上海城建学院
华东师范大学	上海第二教育学院
上海交通大学	上海第二医科大学
上海第二工业大学	上海第三钢铁厂职工大学
上海第二工业大学	上海第一钢铁厂职工大学
上海第二工业大学	上海冶金职工大学
上海第二工业大学	上海冶金联合职工大学
上海第二工业大学	上海东沪职业技术学院
上海对外经贸大学	上海对外贸易学院
上海大学	上海法律高等专科学校
东华大学	上海纺织高等专科学校
上海商学院	上海供销职工大学
上海大学	上海工业大学
上海工艺美术职业学院	上海工艺美院
上海海事大学	上海海大
上海海洋大学	上海海洋
上海海事大学	上海海运学院
上海海事职业技术学院	上海海职
上海应用技术大学	上海化工高等专科学校
上海理工大学	上海机械高等专科学校
上海师范大学	上海技术师范学院
同济大学	上海建材学院
上海交通大学	上海交大
华东师范大学	上海教育学院
上海大学	上海科技大学
上海大学	上海科技高等专科学校
上海商学院	上海粮食局职工大学
上海交通大学	上海农学院
上海应用技术大学	上海轻工业高等专科学校
上海工艺美术职业学院	上海轻工业职工大学
上海工艺美术职业学院	上海第二轻工业局职工大学
上海工艺美术职业学院	上海第二轻工业职工大学
上海商学院	上海商业局一局职工大学
上海师范大学	上海师大
上海师范大学	上海师范高等专科学校
华东理工大学	上海石化高等专科学校
上海工艺美术职业学院	上海市轻工业局职工大学
上海市化学工业职工大学	上海市塑料公司职工大学
上海市化学工业职工大学	上海市橡胶公司职工大学
上海电子信息职业技术学院	上海市仪表电讯工业局职工大学
上海电子信息职业技术学院	上海市仪器仪表公司职工大学
上海电子信息职业技术学院	上海市仪表电子工业职工大学
上海工艺美术职业学院	上海市造纸公司职工大学
上海工艺美术职业学院	上海市钟表公司职工大学
上海工艺美术职业学院	上海市轻工业职工大学
上海工艺美术职业学院	上海轻工业职工大学
上海海洋大学	上海水产大学
同济大学	上海铁道大学
同济大学	上海铁道学院
同济大学	上海铁道医学院
上海兴伟学院	上海托普信息技术职业学院
上海兴伟学院	上海兴韦信息技术职业学院
上海应用技术大学	上海冶金高等专科学校
上海应用技术大学	上海应用技术学院
复旦大学	上海医科大学
上海中医药大学	上海医学高等专科学校
上海健康医学院	上海医药高专
上海健康医学院	上海医药高等专科学校
上海健康医学院	上海健康职业技术学院
华东师范大学	上海幼儿师范高等专科学校
上海理工大学	上理工
上海理工大学	上理
上海农林职业技术学院	上农
上饶师范学院	上饶师院
上海商学院	上商
上海师范大学	上师大
上海外国语大学	上外
上海政法学院	上政
上海中医药大学	上中医
韶关学院	韶大
韶关学院	韶关大学
韶关学院	韶关教育学院
韶关学院	韶关师范专科学校
韶关学院	韶医
绍兴文理学院	绍兴高等专科学校
绍兴文理学院	绍兴师范专科学校
绍兴职业技术学院	绍兴托普信息职业技术学院
绍兴文理学院	绍兴职工大学
邵阳广播电视大学	邵阳电大
邵阳学院	邵阳高等专科学校
邵阳学院	邵阳师范高等专科学校
邵阳学院	邵院
邵阳职业技术学院	邵职院
湖南涉外经济学院	涉外
深圳大学	深大
深圳信息职业技术学院	深信院
深圳大学	深圳师范专科学校
深圳信息职业技术学院	深圳信息学院
深圳职业技术学院	深职学院
沈阳大学	沈大
沈阳工业大学	沈工大
沈阳工程学院	沈工院
沈阳航空航天大学	沈航
沈阳化工大学	沈化
沈阳建筑大学	沈建大
沈阳建筑大学	沈建工
沈阳理工大学	沈理工
沈阳农业大学	沈农
沈阳师范大学	沈师大
沈阳师范大学	沈师
沈阳广播电视大学	沈阳电大
沈阳工程学院	沈阳电力高等专科学校
沈阳航空职业技术学院	沈阳飞机制造公司职工工学院
沈阳航空职业技术学院	沈阳航空职工大学
沈阳航空职业技术学院	黎明发动机制造公司职工工学院
沈阳大学	沈阳工业高等专科学校
沈阳理工大学	沈阳工业学院
沈阳航空航天大学	沈阳航空工业学院
沈阳化工大学	沈阳化工
沈阳化工大学	沈阳化工学院
沈阳科技学院	科亚
沈阳科技学院	沈阳化工大学科亚学院
东北大学	沈阳黄金学院
沈阳建筑大学	沈阳建筑工程学院
沈阳职业技术学院	沈阳联合职工大学
沈阳师范大学	沈阳师范学院
沈阳职业技术学院	沈阳市机电工业学校
沈阳职业技术学院	沈阳职工大学
沈阳药科大学	沈药
沈阳医学院	沈医
郑州升达经贸管理学院	升达
郑州升达经贸管理学院	升达学院
郑州升达经贸管理学院	升达大学
山东劳动职业技术学院	山东技术学院
广西师范学院师园学院	师园学院
石河子大学	石河子农学院
石河子大学	石河子医学院
河北工程技术学院	石家庄法商职业学院
河北工程技术学院	石家庄城市职业学院
石家庄工程职业学院	石家庄计算机职业学院
河北地质大学	石家庄经院
河北地质大学	石家庄经济学院
石家庄科技信息职业学院	石家庄科信学院
石家庄铁道大学	石家庄铁道学院
石家庄财经职业学院	石家庄外经贸职业学院
石家庄经济职业学院	石家庄外事职业学院
石家庄信息工程职业学院	石家庄信息学院
河北医科大学	石家庄医学高等专科学校
河北医科大学	石家庄医学高专
河北地质大学	石经院
中国石油大学	石油大学
中国石油大学	中国石油大学华东
中国石油大学	中国石油大学北京
中国石油大学	中国石油大学(华东)
中国石油大学	中国石油大学(北京)
中国石油大学	中国石油大学（华东）
中国石油大学	中国石油大学（北京）
上海城建职业学院	上海城市管理职业技术学院
上海城建职业学院	市建筑工程职工大学
上海城建职业学院	上海市业余土木建筑学院
上海城建职业学院	市政工程局职工大学
上海城建职业学院	上海城市管理技术职业学校
南昌市职工科技大学	市职科大
首都经济贸易大学	首都经贸
首都联合职工大学	首联大
首都师范大学	首师大
浙江树人学院	zjsru
浙江树人学院	树人
浙江树人学院	浙江树人大学
西北农林科技大学	水利部西北水利科学研究所
湖北水利水电职业技术学院	水利水电职院
私立华联学院	私联学院
四川财经职业学院	四川财经职院
西南大学	四川畜牧兽医学院
四川广播电视大学	四川电大
四川工程职业技术学院	四川工程职院
四川工商职业技术学院	四川工商职院
西华大学	四川工业学院
四川管理职业学院	四川管理职院
四川航天职业技术学院	四川航天职院
四川化工职业技术学院	四川化工职院
四川建筑职业技术学院	四川建院
四川交通职业技术学院	四川交通职院
四川工业科技学院	四川警安职院
四川工业科技学院	四川工管职院
四川工业科技学院	四川警安职业学院
四川工业科技学院	四川工业管理职业学院
四川警察学院	四川警院
四川工商职业技术学院	四川轻工校
四川理工学院	四川轻化工学院
四川理工学院	四川理工大学
重庆三峡学院	四川三峡学院
成都理工大学	四川商业高等专科学校
四川师范大学	四川师大
西华师范大学	四川师范学院
四川水利职业技术学院	四川水利学院
四川外国语大学	四川外语学院
西南医科大学	四川医科大学
第四军医大学	四军大
吉林师范大学	四平师范学院
第四军医大学	四医大
苏州大学	苏大
西南财经大学	苏菲
苏州工业职业技术学院	苏工院
苏州大学	苏州蚕桑专科学校
苏州工艺美术职业技术学院	苏州工艺美院
苏州职业大学	苏州经济管理干部学院
苏州职业大学	苏州市职业大学
江苏联合职业技术学院	苏州市电子工业局职工大学
江苏联合职业技术学院	苏州市工艺美术职工大学
江苏联合职业技术学院	苏州市化学工业局职工大学
江苏联合职业技术学院	苏州市商业职工大学
江苏联合职业技术学院	苏州市业余美术专科学校
江苏联合职业技术学院	苏州市职工大学
江苏联合职业技术学院	苏州建设交通高等职业技术学校
苏州大学	苏州丝绸工学院
苏州科技大学	usts
苏州科技大学	苏科大
苏州科技大学	苏州城建环保学院
苏州科技大学	苏州城市建设环境保护学院
苏州科技大学	苏州铁道师范学院
苏州科技大学	苏州科技学院
苏州大学	苏州医学院
绥化学院	绥大su
塔里木大学	塔大
塔里木大学	塔里木农垦大学
国立台北大学	台北大
国立台北大学	台北大学
国立台北大学	国立台北大学
国立台湾大学	台大
国立台湾科技大学	台科大
国立台湾科技大学	台科
国立台湾科技大学	台湾科大
国立台湾科技大学	台湾科技大学
国立台湾科技大学	国立台湾科技大学
国立台湾师范大学	台师大
台州学院	台院
太原学院	太大
太原工业学院	太工
太原师范学院	太师
太原理工大学	太原工业大学
太原科技大学	太原科大
山西机电职工学院	太原矿山机器厂职工大学
太原学院	太原师范学校
太原师范学院	太原师范专科学校
太原师范学院	太原师院
山西机电职工学院	太原市机械工业局职工大学
太原学院	太原市教育学院
太原学院	太原市园林技校
太原学院	太原大学
山西机电职工学院	太原重型机械厂职工大学
太原科技大学	太原重型机械学院
泰山学院	泰安教育学院
泰山学院	泰安师范学校
泰山学院	泰安师范专科学校
泰山学院	泰安市广播电视大学
泰山学院	泰山乡镇企业职工大学
泰山医学院	泰医
泰山学院	泰院
江苏联合职业技术学院	泰州机电学校
江苏联合职业技术学院	泰州机电高等职业技术学校
唐山学院	唐山高等专科学校
唐山学院	唐山市职工大学
唐山学院	唐院
景德镇陶瓷大学	陶院
景德镇陶瓷大学	景德镇陶瓷学院
北京体育大学	体大
河北体育学院	体院
天津财经大学	天财
天津大学	天大
天津工业大学	天工大
天津财经大学	天津财大
天津财经大学	天津财经学院
天津城建大学	天津城市建设学院
天津医科大学	天津第二医学院
天津广播电视大学	天津电大
天津商务职业学院	天津对外经济贸易职业学院
南开大学	天津对外贸易学院
天津工业大学	天津纺织工学院
天津职业技术师范大学	天津工程师范学院
天津师范大学	天津教育学院
天津理工大学	天津理工学院
天津科技大学	天津轻工业学院
天津商业大学	天津商学院
天津师范大学	天津师范高等专科学校
天津商务职业学院	天津市财贸管理干部学院
天津工业大学	天津市经济管理干部学院
天津工业大学	天津市职工纺织学院
天津工业大学	天津市电子仪表局职工大学
天津工业大学	天津工业职业技术学院
天津中德应用技术大学	天津市职工现代企业管理学院
天津外国语大学	天津外国语学院
天津现代职业技术学院	天津现代
天津医科大学	天津医大
天津医科大学	天津医学院
天津中德应用技术大学	天津职工工业技术学院
天津职业技术师范大学	天津职业技术师范学院
天津中德应用技术大学	天津中德
天津中德应用技术大学	天津中德职业技术学院
天津中医药大学	天津中医大
天津中医药大学	天津中医学院
天津科技大学	天科
天津理工大学	天理工
天津理工大学	天理
天津美术学院	天美
天津农学院	天农
天津商业大学	天商
天津师范大学	天师大
天津师范大学	天师
天水师范学院	天水师院
天津外国语大学	天外
天津音乐学院	天音
石家庄铁道大学	铁大
铁岭师范高等专科学校	铁岭师专
铁岭师范高等专科学校	铁岭市教育学院
铁岭师范高等专科学校	铁岭师范专科学校
南通大学	通大
通化师范学院	通师
海南热带海洋学院	琼大
海南热带海洋学院	琼院
海南热带海洋学院	琼州大学
海南热带海洋学院	琼州学院
海南热带海洋学院	通什教育学院
海南热带海洋学院	通什师范专科学校
同济大学	同济
华中科技大学	同济医科大学
铜陵学院	铜大
铜陵学院	铜陵财经专科学校
铜陵学院	铜陵师范学校
铜仁学院	铜仁教育学院
铜仁学院	铜仁师范专科学校
铜仁职业技术学院	铜仁职院
外交学院	外交院
对外经济贸易大学	外经贸
西安外事学院	外事
武昌工学院	武汉工业学院工商学院
皖西学院	皖西联合大学
重庆三峡学院	万县教院
重庆三峡学院	万县师范专科学校
重庆机电职业技术学院	望江机器厂职工大学
潍坊学院	潍坊高等专科学校
潍坊医学院	潍医
潍坊学院	潍院
渭南师范学院	渭南教育学院
渭南师范学院	渭南师范专科学校
渭南师范学院	渭南师院
温州大学	温大
四川交通职业技术学院	温江交院
成都农业科技职业学院	温江农校
温州医科大学	温医大
温州大学	温州师范学院
温州商学院	温州大学城市学院
温州医科大学	温州医学院
无锡城市职业技术学院	无锡机床厂职工大学
江南大学	无锡教育学院
无锡科技职业学院	无锡科院
江南大学	无锡轻工大学
无锡城市职业技术学院	无锡市电子仪表工业局职工大学
无锡城市职业技术学院	无锡市化学工业局职工大学
无锡城市职业技术学院	无锡市机械工业联合职工大学
无锡城市职业技术学院	无锡市轻工业局职工大学
无锡城市职业技术学院	无锡市职工大学
梧州学院	梧院
安徽师范大学	芜湖师范专科学校
芜湖职业技术学院	芜湖信息学院
芜湖职业技术学院	芜湖信息技术职业学院
芜湖职业技术学院	芜湖教育学院
辽宁兵器工业职工大学	五三工厂职工大学
五邑大学	五邑
武汉大学	武大
武汉工程大学	武工大
武汉大学	武汉测绘科技大学 湖北医科大学
武汉工商学院	武汉长江工商学院
华中科技大学	武汉城市建设学院
武汉船舶职业技术学院	武汉船院
武汉纺织大学	武汉纺织工学院
武汉科技大学	武汉钢铁学院
武汉工贸职业学院	武汉工贸
武汉理工大学	武汉工业大学
武汉理工大学	武汉汽车工业大学
武汉轻工大学	武汉工业学院
武汉航海职业技术学院	武汉航院
武汉理工大学	武汉河运专科学校
武汉理工大学	武汉水运工程学院
武汉理工大学	武汉交通科技大学
武汉工程大学	武汉化工学院
武汉机械工业学校	武汉机床厂职工大学
武汉机械工业学校	武汉市机械工业职工大学
武汉科技大学	武汉建筑高等专科学校
武汉交通职业学院	武汉交通政治管理干部学院
武汉交通职业学院	长江航运职工大学
武汉交通职业学院	武汉交通管理干部学院
湖北经济学院	武汉金融高等专科学校
武汉科技大学	武汉科大
武汉纺织大学	武汉科技学院
华中科技大学	武汉科技职工大学
武汉民政职业学院	武汉民政
武汉轻工大学	武汉轻工
武汉商学院	武汉肉联厂职工大学
武汉商学院	武汉职工财经学院
武汉轻工大学	武汉食品工业学院
武汉软件工程职业学院	武汉市广播电视大学
武汉软件工程职业学院	汉口职业技术学院
武汉软件工程职业学院	武汉软件职业学院
武汉软件工程职业学院	武汉工交职业学院
武汉机械工业学校	武汉市锅炉厂职工大学
武汉机械工业学校	武汉市机械工业局职工大学
武汉商学院	武汉市建筑工业总公司职工大学
武汉商学院	武汉市二轻职工大学
武汉商学院	武汉市职工大学
武汉商学院	武汉商业服务学院
江汉大学	武汉市职工医学院
武汉大学	武汉水利电力大学
三峡大学	武汉水利电力大学宜昌校区
武汉体育学院	武汉体院
武汉科技大学	武汉冶金科技大学
武汉科技大学	武汉冶金医学高等专科学校
武昌职业学院	武汉语言文化职业学院
武汉机械工业学校	武汉重型机床厂职工大学
武汉科技大学	武科大
武汉理工大学	武理工
吉首大学	武陵高等专科学校
武汉生物工程学院	武生院
武汉信息传播职业技术学院	武信学院
武汉音乐学院	武音
武汉职业技术学院	武职
西安文理学院	西安大学
长安大学	西安公路交通大学
西安工程大学	西安工程科技学院
长安大学	西安工程学院
西安工业大学	西安工大
西安工业大学	西安工业学院
西安航空职工大学	西安航空发动机公司职工工学院
西安航空职业技术学院	西安航院
西安财经学院	西安基础大学
西安建筑科技大学	西安建筑科大
西安交通大学	西安交大
西安文理学院	西安教育学院
西安科技大学	西安矿业学院
西安理工大学	西安理工
西安文理学院	西安理院
西安文理学院	西安联合大学
西安城市建设职业学院	西安三资职业学院
西安文理学院	西安师范专科学校
西安石油大学	西安石油学院
西安体育学院	西安体院
西安财经学院	西安统计学院
西安外国语大学	西安外国语学院
西安交通大学	西安医科大学
西安邮电大学	西安邮电学院
西安工程大学	西北纺织工学院
长安大学	西北建筑工程学院
西北农林科技大学	西北林学院
西北民族大学	西北民大
西北民族大学	西北民族学院
西北农林科技大学	西北农大
西北农林科技大学	西北农业大学
陕西科技大学	西北轻工业学院
陕西科技大学	西北轻工
西北师范大学	西北师大
西北政法大学	西北政法学院
西南财经大学	西财
西藏民族大学	西藏民族学院
西藏民族大学	西藏民大
西藏民族大学	西藏民族学院
西藏大学	西藏农牧学院
西昌学院	西昌农业高等专科学校
西昌学院	西昌师范高等专科学校
西安电子科技大学	西电
西北政法大学	西法大
西北工业大学	西工大
肇庆学院	西江大学
西安电子科技大学	西军电
西安交通工程学院	西科贸
西安交通工程学院	西安科技商贸学院
西安理工大学	西理
西南林业大学	西林
西安美术学院	西美
西南财经大学	西南财大
重庆机电职业技术学院	西南车辆制造厂职工大学
重庆机电职业技术学院	重庆机电职业技术学院
西南大学	西南大
西南科技大学	西南工学院
西南交通大学	西南交大
唐山学院	西南交通大学唐山分校
西南科技大学	西南科大
西南林业大学	西南林学院
重庆冶金成人学院	西南铝加工厂职工大学
西南民族大学	西南民大
西南大学	西南农业大学
西南大学	西南师范大学
西南大学	重庆西南大学
西南石油大学	西南石油
西南石油大学	西南石油学院
青海省联合职工大学	西宁钢厂职工大学
西交利物浦大学	西浦
山西煤炭职工联合大学	西山矿务局职工大学
西安石油大学	西石油
上海外国语大学	西索
西安外国语大学	西外
西安医学院	西医院
西安音乐学院	西音
西安邮电大学	西邮
西南政法大学	西政
锡林郭勒职业学院	锡大
湖北科技学院	咸宁师范高等专科学校
湖北科技学院	咸宁学院
湖北科技学院	咸宁医学院
咸阳师范学院	咸阳教育学院
咸阳师范学院	咸阳师范专科学校
咸阳师范学院	咸阳师院
湘潭大学	湘大
湖南工业大学	湘工大
湖南中医药大学	湘潭工学院
湖南工程学院	湘潭机电高等专科学校
湖南中医药大学	湘潭师范学院
湘潭医卫职业技术学院	湘潭职院
湘潭医卫职业技术学院	湘潭职业技术学院
湘潭医卫职业技术学院	湘潭职院
湘南学院	湘院
襄樊广播电视大学	襄樊电大
湖北文理学院	襄樊教育学院
湖北文理学院	襄樊学院
湖北文理学院	襄樊职业大学
襄阳职业技术学院	襄樊职业技术学院
湖北文理学院	襄阳师范高等专科学校
襄阳职业技术学院	襄职
南京晓庄学院	晓庄师范
湖北工程学院	孝感学院
山东协和学院	山东协和职业技术学院
忻州师范学院	忻州地区教育学院
忻州师范学院	忻州师范高等专科学校
忻州师范学院	忻州师范
忻州师范学院	忻州师范学校
忻州师范学院	忻州师范专科学校
忻州师范学院	忻州职工大学
忻州职业技术学院	忻州职院
新疆大学	新大
新疆工程学院	新工专
新疆工程学院	新疆工业高等专科学校
山西兵器工业职工大学	新华化工厂职工工学院
新疆财经大学	新疆财经学院
新疆财经大学	新疆财政学校
新疆广播电视大学	新疆电大
新疆大学	新疆工学院
新疆财经大学	新疆经济管理干部学院
石河子大学	新疆生产建设兵团经济专科学校
石河子大学	新疆生产建设兵团师范专科学校
新疆师范大学	新疆师大
新疆医科大学	新疆医科大
新疆医科大学	新疆医学院
新疆医科大学	新疆中医学院
新疆农业大学	新农大
新乡医学院	新医
新疆艺术学院	新艺
新乡学院	新院
信阳农林学院	信阳农林
信阳农林学院	信阳农业高等专科学校
信阳师范学院	“信阳师院”
信阳职业技术学院	信阳职院
山西兵器工业职工大学	兴安化学材料厂职工大学
山西应用科技学院	兴华学院
山西应用科技学院	山西兴华职业学院
兴义民族师范学院	兴义师院
兴义民族师范学院	黔西南民族师专
星海音乐学院	星海
邢台学院	邢台师范高等专科学校
邢台医学高等专科学校	邢台医专
邢台学院	邢院
徐州医科大学	徐医
徐州医科大学	徐医大
徐州医科大学	徐州医学院
徐州工程学院	徐州工院
江苏建筑职业技术学院	徐州建筑职业技术学院
徐州工程学院	徐州经济管理干部学院
江苏师范大学	徐州师范大学
徐州工程学院	徐州市职工大学
雅安职业技术学院	雅职院
烟台大学	烟大
鲁东大学	烟台师范学院
烟台职业学院	烟职
延安大学	延安医学院
延边大学	延边农学院
延边大学	延边师范高等专科学校
延边大学	延边医学院
延边职业技术学院	延吉市职工大学
延边职业技术学院	石岘造纸厂职工大学
延边职业技术学院	延边职工大学
盐城工学院	盐城工业专科学校
盐城师范学院	盐城教育学院
盐城师范学院	盐城师范专科学校
盐城工学院	盐城市纺织职工大学
盐城工学院	盐城职业大学
盐城工学院	盐工
盐城师范学院	盐师
盐城卫生职业技术学院	盐卫
燕山大学里仁学院	燕大里仁
燕山大学里仁学院	里仁学院
燕山大学	燕大
首都经济贸易大学	燕京华侨职业学院
山西大同大学	雁北师范学院
中央财经大学	央财
扬州大学	扬大
扬州大学	扬州工学院
扬州大学	扬州师范学院
扬州大学	扬州医学院
杨凌职业技术学院	杨凌职院
山西煤炭职工联合大学	阳泉矿务局职工大学
中国药科大学	药大
西藏藏医学院	药王山藏医学院
伊春职业学院	伊春职院
伊犁师范学院	伊犁师范
宜宾学院	宜宾教育学院
宜宾职业技术学院	宜宾农校
宜宾学院	宜宾师范高等专科学校
宜宾职业技术学院	宜宾职院
三峡大学	宜昌师范专科学校
三峡大学	宜昌医学专科学校
三峡大学	宜昌职业大学
宜昌市广播电视大学	宜春电大
宜春学院	宜春农业专科学校
宜春学院	宜春师范专科学校
宜春学院	宜春市职工业余大学
宜春学院	宜春医学专科学校
义乌工商职业技术学院	义乌工商职院
义乌工商职业技术学院	义乌工商学院
湖南城市学院	益阳师范高等专科学校
益阳职业技术学院	益阳职院
五邑大学	邑大
宁夏大学	银川师范专科学校
银川能源学院	银大
银川能源学院	银川大学
山东英才学院	英才学院
北京电子科技学院	besti
兰州大学	lzu
营口职业技术学院	营口大学
营口职业技术学院	营口高等职业专科学校
营口职业技术学院	营口师范高等专科学校
营口职业技术学院	营口市电大
营口职业技术学院	营口市教育学院
营口职业技术学院	营口市职工大学
华北科技学院	有色金属管理干部学院
华北科技学院	华北矿业高等专科学校
右江民族医学院	右医
重庆文理学院	渝西学院
重庆工商大学	渝州大学
重庆文理学院	渝州教育学院
常熟理工学院	虞理工
玉林师范学院	玉林师范高等专科学校
玉林师范学院	玉林市高等职业技术学院
玉林师范学院	玉林市教育学院
玉溪师范学院	玉溪成人教育培训中心
玉溪师范学院	玉溪师范高等专科学校
玉溪师范学院	玉溪师范学校
玉溪师范学院	玉溪师院
河南工程学院	豫工院
河南工程学院	河南纺织高等专科学校
河南工程学院	郑州经济管理干部学院
湖南理工学院	岳阳大学
岳阳广播电视大学	岳阳电大
湖南理工学院	岳阳师范高等专科学校
湖南理工学院	岳阳师范学院
云南财经大学	云财
云南大学	云大
云南城市建设职业学院	云南北美职业学院
云南财经大学	云南财大
云南财经大学	云南财贸学院
云南开放大学	云南电大
昆明理工大学	云南工学院
昆明理工大学	云南工业大学
云南国防工业职业技术学院	云南光学仪器厂职工大学
云南国防工业职业技术学院	西南仪器厂职工工业学院
云南国防工业职业技术学院	云南兵器工业职工大学
红河学院	云南广播电视大学红河分校
云南开放大学	云南广播电视大学
昆明理工大学	云南化工专科学校
云南师范大学	云南教育学院
云南财经大学	云南经济管理干部学院
云南财经大学	云南财贸学院
云南民族大学	云南民大
云南民族大学	云南民族学院
云南师范大学	云南师大
云南大学	云南政法高等专科学校
云南农业大学	云农大
云南艺术学院	云艺
云南中医学院	云中
湖北医药学院	郧阳医学院
运城学院	运院
枣庄学院	枣院
云南警官学院	责任
广东医科大学	湛江广医
广东医科大学	湛江医学院
广东医科大学	广东医学院
广东海洋大学	湛江海洋大学
广东海洋大学	湛江农业专科学校
岭南师范学院	湛江师范学院
广东海洋大学	湛江水产学院
广东文理职业学院	湛江现代科技职业学院
岭南师范学院	湛师
张家口学院	张家口教育学院
河北北方学院	张家口农业高等专科学校
河北北方学院	张家口师范专科学校
河北北方学院	张家口医学院
张家口职业技术学院	张家口职院
张家口学院	张院
漳州职业技术学院	漳大
漳州理工职业学院	漳州吉马印刷职业技术学院
漳州职业技术学院	漳州农业机械学校
闽南师范大学	漳州师范学院
漳州科技职业学院	漳州天福茶职业技术学院
漳州职业技术学院	漳州职业大学
朝阳师范高等专科学校	朝阳师专
朝阳师范高等专科学校	朝阳市第一师范学校
朝阳师范高等专科学校	朝阳市教育学院
朝阳师范高等专科学校	朝阳师范专科学校
朝阳师范高等专科学校	朝阳职工大学
广东工商职业学院	肇庆工商学院
广东工商职业学院	肇庆工商职业技术学院
肇庆学院	肇庆教育学院
肇庆学院	肇庆师范专科学校
肇庆医学高等专科学校	肇庆医专
内蒙古民族大学	哲里木畜牧学院
浙江传媒学院	浙传
浙江大学	浙大
浙江工业大学	浙工大
浙江工业大学	杭工大
浙江工业大学	杭州工业大
浙江工业大学	杭州工业大学
浙江海洋大学	浙海院
浙江海洋大学	浙江海洋学院
浙江财经大学	浙江财经学院
绍兴文理学院	浙江电大绍兴分校
浙江理工大学	浙江工程学院
嘉兴学院	浙江经济高等专科学校
浙江警察学院	浙江警院
浙江警察学院	浙江公安高等专科学校
浙江农林大学	浙江林学院
浙江万里学院	浙江农村技术师范专科学校
浙江农林大学	浙江农林大
浙江大学	浙江农业大学
浙江商业职业技术学院	浙江商职院
宁波大学	浙江水产学院宁波部分
浙江海洋大学	浙江水产学院
浙江理工大学	浙江丝绸工学院
浙江理工大学	浙江工程学院
浙江大学	浙江医科大学
浙江工商大学	浙江政法管理干部学院
浙江工商大学杭州商学院	杭州商学院
浙江中医药大学	浙江中医学院
浙江经贸职业技术学院	浙经贸职院
浙江理工大学	浙理工
浙江工商大学	浙商大
浙江师范大学	浙师大
浙江水利水电学院	zjweu
浙江水利水电学院	浙水院
浙江水利水电学院	浙江水利水电专科学校
浙江万里学院	浙万院
镇江市高等专科学校	镇江教育学院
江苏大学	镇江师范专科学校
镇江市高等专科学校	镇江市职业大学
江苏大学	镇江医学院
郑州大学	郑大
郑州航空工业管理学院	郑航
郑州轻工业学院	郑轻
郑州师范学院	郑师
郑州师范学院	郑州师范高等专科学校
郑州城市职业学院	郑州布瑞达理工职业学院
郑州广播电视大学	郑州电大
中原工学院	郑州纺织工学院
河南工业大学	郑州工程学院
郑州大学	郑州工业大学
河南工业大学	郑州工业高等专科学校
郑州航空工业管理学院	郑州航院
郑州工业应用技术学院	郑州华信学院
郑州工业应用技术学院	郑州华院
郑州工业应用技术学院	郑州工业学院
郑州科技学院	郑州科院
郑州科技学院	郑州科技职业学院
河南工业大学	郑州粮食学院
郑州旅游职业学院	郑州旅院
河南工程学院	郑州煤田职工地质学院
河南工程学院	郑州煤炭管理干部学院
郑州轻工业学院	郑州轻院
广西职业技术学院	职院
中北大学	中北
中央财经大学	中财
中国传媒大学	中传
中山大学	中大
中原工学院	中工
东华大学	中国纺织大学
中国海洋大学	中国海大
对外经济贸易大学	中国金融学院
西北农林科技大学	中国科学院水利部水土保持研究所
中国科学院大学	中国科学院研究生院
中国矿业大学	中国矿大
中国矿业大学	中国矿业大学北京
中国矿业大学	中国矿业大学徐州
中国矿业大学	中国矿业大学江苏
中国矿业大学	中国矿业大学（北京）
中国矿业大学	中国矿业大学（徐州）
中国矿业大学	中国矿业大学（江苏）
中国矿业大学	中国矿业大学(北京)
中国矿业大学	中国矿业大学(徐州)
中国矿业大学	中国矿业大学(江苏)
山东工商学院	中国煤炭经济学院
中国民航大学	中国民用航空学院
中国民航大学	中国民用航空大学
中国农业大学	中国农大
西南大学	中国农业科学院柑桔研究所
中国人民大学	中国人大
第二军医大学	中国人民解放军第二军医大学
中国人民公安大学	中国人民警官大学
北京协和医学院	中国协和医科大学
中国医科大学	中国医大
四川建筑职业技术学院	中国重型机械集团公司职工大学
山东交通学院	中国重型汽车集团公司职工大学
中国海洋大学	中海大
中南财经政法大学	中南财经大学
南华大学	中南工学院
中南大学	中南工业大学
中南林业科技大学	中南林学院
中南林业科技大学	中南林
中南民族大学	中南民大
中南民族大学	中南民族学院
中南财经政法大学	中南政法大学
中国青年政治学院	中青院
中国青年政治学院	中青政
中山火炬职业技术学院	中山火炬职院
成都电子科技大学	中山学院
中山大学	中山医科大学
香港中文大学	中文大学
中央财经大学	中央财大
中央财经大学	中央财政管理干部学院
清华大学	中央工艺美术学院
中国政法大学	中央政法管理干部学院
北京中医药大学	中医药大学
中央音乐学院	中音
武汉机械工业学校	中原机械厂职工大学
中国政法大学	中政
云南警官学院	忠诚
仲恺农业工程学院	仲恺农业技术学院
仲恺农业工程学院	仲恺农工学院
重庆大学	重大
重庆科技学院	cqust
重庆科技学院	重科
重庆科技学院	重庆科技大学
重庆科技学院	重庆工业高等专科学校
重庆科技学院	重庆石油高等专科学校
重庆房地产职业学院	重庆巴渝职业技术学院
重庆冶金成人学院	重庆钢铁公司职工大学
重庆工程职业技术学院	重庆工程职院
重庆工商大学	重庆工商
重庆理工大学	重庆工学院
重庆理工大学	重庆工业管理学院
重庆大学	重庆建筑大学
重庆大学	重庆建筑高等专科学校
昆明理工大学	重庆建筑工程学院昆明分院
重庆建筑工程职业学院	重庆建筑勘察设计院职工大学
重庆建筑工程职业学院	重庆建筑职工大学
重庆建筑工程职业学院	重庆城建职工学院
重庆电讯职业学院	重庆江津职业学院
重庆交通大学	重庆交大
重庆交通大学	重庆交通学院
重庆理工大学	重庆经济管理干部学院
重庆警察学院	重庆警院
重庆警察学院	重庆警官职业院
重庆警察学院	重庆警官职业学院
重庆文理学院	重庆理院
重庆工商大学	重庆商学院
重庆师范大学	重庆师大
重庆文理学院	重庆师范高等专科学校
重庆师范大学	重庆师范学院
重庆师范大学	重庆市纺织工业局职工大学
西南大学	重庆市轻工业职工大学
重庆师范大学	重庆市幼儿师范学校
重庆冶金成人学院	重庆特殊钢厂职工大学
重庆邮电大学	重庆邮电学院
重庆医科大学	重庆职工医学院
重庆三峡学院	重三大
重庆师范大学	重师
重庆医科大学	重医
重庆邮电大学	重邮
周口师范学院	周口教育学院
周口师范学院	周口师范高等专科学校
周口职业技术学院	周职
浙江海洋大学	舟山师范专科学校
湖南省广播电视大学	株洲电大
湖南工业大学	株洲工学院
广东开放大学	珠海电大
珠海艺术职业学院	珠海艺术学院
黄淮学院	驻马店师范高等专科学校
山东理工大学	淄博教育学院
山东理工大学	淄博师范专科学校
山东理工大学	淄博市职工大学
山东理工大学	淄博学院
南通理工学院	紫琅学院
四川理工学院	自贡高等专科学校
四川理工学院	自贡教育学院
四川理工学院	自贡师范高等专科学校
遵义师范学院	遵师
遵义师范学院	遵义师范高等专科学校
遵义师范学院	遵义教育学院
遵义医药高等专科学校	遵义医校
遵义职业技术学院	遵义职院
河北东方学院	廊坊东方职业技术学院
河北东方学院	廊坊东方学院
河北环境工程学院	中国环境管理干部学院
河北环境工程学院	环保学院
河北环境工程学院	中环院
山西警察学院	山西警官高等专科学校
山西警察学院	山西警专
山西能源学院	山西煤炭管理干部学院
山西能源学院	山能
四平农村成人高等专科学校	梨树农村成人高等专科学校
黑龙江工商学院	东北农业大学成栋学院
上海公安学院	上海公安高等专科学校
上海工商职业技术学院	上海新侨职业技术学院
上海城建职业学院	上海工会管理职业学院
上海城建职业学院	上海建峰职业技术学院
南京特殊教育师范学院	南京特殊教育职业技术学院
杭州医学院	浙江医学高等专科学校
杭州医学院	杭医
亳州学院	亳州师范高等专科学校
亳州学院	亳院
安徽信息工程学院	安徽工程大学机电学院
安徽信息工程学院	安工程机电学院
福建商学院	福建商业高等专科学校
福建商学院	福建商专科
厦门医学院	厦门医学高等专科学校
厦门医学院	厦门医学职业技术学院
厦门华厦学院	厦门华厦职业学院
厦门华厦学院	华厦学院
福州理工学院	福州海峡职业技术学院
阳光学院	福州大学阳光学院
厦门工学院	华侨大学厦门工学院
厦门工学院	厦工院
江西传媒职业学院	江西新闻出版职业技术学院
山东现代学院	山东现代职业学院
郑州工程技术学院	中州大学
河南财政金融学院	河南财政税务高等专科学校
河南财政金融学院	河南教育学院
河南财政金融学院	河南财专
河南应用技术职业学院	河南化工职业学院
河南应用技术职业学院	河应院
开封文化艺术职业学院	开封教育学院
开封文化艺术职业学院	开封广播电视大学
开封文化艺术职业学院	开封第一师范学校
开封文化艺术职业学院	开封第二师范学校
郑州工商学院	河南理工大学万方科技学院
安阳学院	安阳师范学院人文管理学院
信阳学院	信阳师范学院华锐学院
汉江师范学院	郧阳师范高等专科学校
汉江师范学院	郧阳师专
武昌首义学院	华中科技大学武昌分校
武昌首义学院	首义学院
武汉学院	中南财经政法大学武汉学院
武汉学院	武院
武汉华夏理工学院	武汉理工大学华夏学院
武汉华夏理工学院	华夏理工
湖北商贸学院	湖北工业大学商贸学院
武汉传媒学院	华中师范大学武汉传媒学院
武汉设计工程学院	华中农业大学楚天学院
武汉晴川学院	武汉大学珞珈学院
邵阳学院	邵阳医学高等专科学校
湖南财经工业职业技术学院	衡阳财经工业职业技术学院
湖南财经工业职业技术学院	衡阳财经工业学院
湖南国防工业职业技术学院	湖南科技工业职业技术学院
广东药科大学	广东药学院
广东药科大学	广东省卫生干部进修学校
岭南师范学院	湛江教育学院
广西科技师范学院	柳州师范高等专科学校
广西警察学院	广西警官高等专科学校
海南热带海洋学院	琼州学院
四川工商学院	四川师范大学成都学院
贵州商学院	贵州商业高等专科学校
贵州航空职业技术学院	贵州航空工业职工大学
云南农业大学	云南热带作物职业学院
滇西科技师范学院	临沧师范高等专科学校
陕西机电职业技术学院	陕西电子工业职工大学
甘肃财贸职业学院	兰州服装职工大学
宁夏葡萄酒与防沙治沙职业技术学院	宁夏林业学校
宁夏葡萄酒与防沙治沙职业技术学院	宁夏生态工程学校
宁夏葡萄酒与防沙治沙职业技术学院	宁夏防沙治沙职业技术学院
上海健康医学院	上海医疗器械高等专科学校
上海开放大学	上海电视大学
成都学院	成都大学
北京吉利学院	北京吉利大学
文华学院	华中科技大学文华学院
河南牧业经济学院	河南商业高等专科学校
燕京理工学院	北京化工大学北方学院
武汉工程科技学院	中国地质大学江城学院
成都文理学院	四川师范大学文理学院
成都电子科技大学中山学院	电子科技大学中山学院
扬州市职业大学	扬州市职业大学
山东财经大学	山东经济学院
江西工程学院	江西渝州科技职业学院
江苏第二师范学院	江苏教育学院
民办四川天一学院	天一学院
民办四川天一学院	四川天一学院
同济大学	上海同济大学
江西应用科技学院	江西城市学院
黑龙江工业学院	鸡西大学
南开大学	天津南开大学
湖南大众传媒职业技术学院	湖南大众传媒学院
重庆人文科技学院	西南大学育才学院
湖南交通工程学院	湖南科技经贸职业学院
云南经济管理学院	云南经济管理职业学院
江西工程学院	江西渝州科技学院
武昌理工学院	武汉科技大学中南分校
黄河科技学院	黄河科技大学
黄河交通学院	郑州交通学院
中国科学技术大学	中科大
中国科学技术大学	中国科大
中国科学技术大学	中国科技大学
中国科学技术大学	合肥经济技术学院
青岛恒星科技学院	青岛恒星学院
成都师范学院	四川教育学院
西京学院	西京大学
郑州升达经贸管理学院	郑州大学升达经贸管理学院
广州航海学院	广州航海高等专科学校
广东省外语艺术职业学院	广东外语艺术职业学院
湖南信息学院	湖南信息科学职业学院
广州工商学院	广州工商职业技术学院
山东省济宁教育学院	山东金乡师范院校
新余学院	江西新佘学院
新余学院	新佘学院
第五冶金建设公司职工大学	五冶职大
南阳医学高等专科学校	南阳卫生学校
南阳医学高等专科学校	河南南阳卫生学校
南阳医学高等专科学校	河南省南阳卫生学校
江海职业技术学院	扬州江海学院
江海职业技术学院	江海学院
江海职业技术学院	江海
安徽工业经济职业技术学院	安徽工业经济学院
兰州工业学院	兰州工业大学
广东科技学院	广东科技大学
麻省理工学院	麻省理工
麻省理工学院	massachusetts institute of technology
斯坦福大学	斯坦福
斯坦福大学	stanford university
哈佛大学	哈佛
哈佛大学	harvard university
加州理工学院	加州理工
加州理工学院	california institute of technology
牛津大学	牛津
牛津大学	university of oxford
剑桥大学	剑桥
剑桥大学	university of cambridge
苏黎世联邦理工学院	苏黎世联邦理工
苏黎世联邦理工学院	eth zurich - swiss federal institute of technology
帝国理工学院	帝国理工
帝国理工学院	imperial college london
芝加哥大学	芝加哥
芝加哥大学	university of chicago
伦敦大学学院	伦敦
伦敦大学学院	ucl (university college london)
新加坡国立大学	新加坡国立
新加坡国立大学	national university of singapore
南洋理工大学	南洋理工
南洋理工大学	nanyang technological university
普林斯顿大学	普林斯顿
普林斯顿大学	princeton university
康奈尔大学	康奈尔
康奈尔大学	cornell university
耶鲁大学	耶鲁
耶鲁大学	yale university
哥伦比亚大学	哥伦比亚
哥伦比亚大学	columbia university
清华大学	清华
清华大学	tsinghua university
爱丁堡大学	爱丁堡
爱丁堡大学	the university of edinburgh
宾夕法尼亚大学	宾夕法尼亚
宾夕法尼亚大学	university of pennsylvania
密歇根大学安娜堡分校	密歇根
密歇根大学安娜堡分校	university of michigan
约翰霍普金斯大学	约翰霍普金斯
约翰霍普金斯大学	johns hopkins university
洛桑联邦理工学院	洛桑联邦理工
洛桑联邦理工学院	epfl - ecole polytechnique federale de lausanne
东京大学	东京
东京大学	the university of tokyo
澳洲国立大学	澳洲国立
澳洲国立大学	the australian national university
香港大学	the university of hong kong
杜克大学	杜克
杜克大学	duke university
加州大学伯克利分校	加州
加州大学伯克利分校	university of california berkeley
多伦多大学	多伦多
多伦多大学	university of toronto
曼彻斯特大学	曼彻斯特
曼彻斯特大学	the university of manchester
北京大学	peking university
伦敦大学国王学院	伦敦
伦敦大学国王学院	king's college london
加州大学洛杉矶分校	加州
加州大学洛杉矶分校	university of california
麦吉尔大学	麦吉尔
麦吉尔大学	mcgill university
西北大学	northwestern university
京都大学	京都
京都大学	kyoto university
首尔国立大学	首尔国立
首尔国立大学	seoul national university
香港科技大学	香港科技
香港科技大学	the hong kong university of science and technology
伦敦政治经济学院	伦敦政治经济
伦敦政治经济学院	london school of economics and political science
墨尔本大学	墨尔本
墨尔本大学	the university of melbourne
韩国高等科技学院	韩国高等科技
韩国高等科技学院	kaist - korea advanced institute of science & technology
加州大学圣地亚哥分校	加州
加州大学圣地亚哥分校	university of california
悉尼大学	悉尼
悉尼大学	the university of sydney
纽约大学	纽约
纽约大学	new york university
复旦大学	复旦
复旦大学	fudan university
新南威尔士大学	新南威尔士
新南威尔士大学	the university of new south wales
卡耐基梅隆大学	卡耐基梅隆
卡耐基梅隆大学	carnegie mellon university
英属哥伦比亚大学	英属哥伦比亚
英属哥伦比亚大学	university of british columbia
昆士兰大学	昆士兰
昆士兰大学	the university of queensland
香港中文大学	香港中文
香港中文大学	the chinese university of hong kong
巴黎第九大学	巴黎第九
巴黎第九大学	université psl
布里斯托大学	布里斯托
布里斯托大学	university of bristol
代尔夫特理工大学	代尔夫特理工
代尔夫特理工大学	delft university of technology
威斯康辛大学麦迪逊分校	威斯康辛
威斯康辛大学麦迪逊分校	university of wisconsin-madison
华威大学	华威
华威大学	the university of warwick
香港城市大学	香港城市
香港城市大学	city university of hong kong
布朗大学	布朗
布朗大学	brown university
阿姆斯特丹大学	阿姆斯特丹
阿姆斯特丹大学	university of amsterdam
东京工业大学	东京工业
东京工业大学	tokyo institute of technology
莫纳什大学	莫纳什
莫纳什大学	monash university
上海交通大学	上海交通
上海交通大学	shanghai jiao tong university
慕尼黑工业大学	慕尼黑工业
慕尼黑工业大学	technical university of munich
慕尼黑大学	慕尼黑
慕尼黑大学	ludwig-maximilians-universit?t münchen
德克萨斯大学奥斯汀分校	德克萨斯
德克萨斯大学奥斯汀分校	university of texas at austin
海德堡大学	海德堡
海德堡大学	ruprecht-karls-universit?t heidelberg
巴黎高等理工学院	巴黎高等理工
巴黎高等理工学院	ecole polytechnique
华盛顿大学	华盛顿
华盛顿大学	university of washington
大阪大学	大阪
大阪大学	osaka university
浙江大学	zhejiang university
格拉斯哥大学	格拉斯哥
格拉斯哥大学	university of glasgow
佐治亚理工学院	佐治亚理工
佐治亚理工学院	georgia institute of technology
伊利诺伊大学厄本那-香槟分校	伊利诺伊
伊利诺伊大学厄本那-香槟分校	university of illinois at urbana-champaign
国立台湾大学	国立台湾
国立台湾大学	national taiwan university (ntu)
布宜诺斯艾利斯大学	布宜诺斯艾利斯
布宜诺斯艾利斯大学	universidad de buenos aires (uba)
杜伦大学	杜伦
杜伦大学	durham university
索邦大学	索邦
索邦大学	sorbonne university
谢菲尔德大学	谢菲尔德
谢菲尔德大学	the university of sheffield
东北大学（日本）	tohoku university
苏黎世大学	苏黎世
苏黎世大学	university of zurich
伯明翰大学	伯明翰
伯明翰大学	university of birmingham
哥本哈根大学	哥本哈根
哥本哈根大学	university of copenhagen
鲁汶大学（荷语）	鲁汶
鲁汶大学（荷语）	ku leuven
诺丁汉大学	诺丁汉
诺丁汉大学	university of nottingham
北卡罗来纳大学教堂山分校	北卡罗来纳
北卡罗来纳大学教堂山分校	university of north carolina
浦项科技大学	浦项科技
浦项科技大学	pohang university of science and technology
奥克兰大学	奥克兰
奥克兰大学	the university of auckland
高丽大学	高丽
高丽大学	korea university
莱斯大学	莱斯
莱斯大学	rice university
马来亚大学	马来亚
马来亚大学	universiti malaya (um)
俄亥俄州立大学	俄亥俄州立
俄亥俄州立大学	the ohio state university
莫斯科国立大学	莫斯科国立
莫斯科国立大学	lomonosov moscow state university
西澳大学	西澳
西澳大学	the university of western australia
隆德大学	隆德
隆德大学	lund university
波士顿大学	波士顿
波士顿大学	boston university
利兹大学	利兹
利兹大学	university of leeds
宾州州立大学公园分校	宾州州立
宾州州立大学公园分校	pennsylvania state university
南安普敦大学	南安普敦
南安普敦大学	university of southampton
圣安德鲁斯大学	圣安德鲁斯
圣安德鲁斯大学	university of st andrews
中国科学技术大学	中国科学技术
中国科学技术大学	university of science and technology of china
埃因霍温理工大学	埃因霍温理工
埃因霍温理工大学	eindhoven university of technology
成均馆大学	成均馆
成均馆大学	sungkyunkwan university (skku)
加州大学戴维斯分校	加州
加州大学戴维斯分校	university of california
普渡大学西拉法叶分校	普渡
普渡大学西拉法叶分校	purdue university
圣路易斯华盛顿大学	圣路易斯华盛顿
圣路易斯华盛顿大学	washington university in st. louis
都柏林三一学院	都柏林三一
都柏林三一学院	trinity college dublin
瑞典皇家理工学院	瑞典皇家理工
瑞典皇家理工学院	kth royal institute of technology
香港理工大学	香港理工
香港理工大学	the hong kong polytechnic university
延世大学	延世
延世大学	yonsei university
日内瓦大学	日内瓦
日内瓦大学	university of geneva
阿尔伯塔大学	阿尔伯塔
阿尔伯塔大学	university of alberta
赫尔辛基大学	赫尔辛基
赫尔辛基大学	university of helsinki
名古屋大学	名古屋
名古屋大学	nagoya university
丹麦理工大学	丹麦理工
丹麦理工大学	technical university of denmark
墨西哥国立自治大学	墨西哥国立自治
墨西哥国立自治大学	universidad nacional autónoma de méxico(unam)
阿德雷德大学	阿德雷德
阿德雷德大学	the university of adelaide
南加州大学	南加州
南加州大学	university of southern california
卡尔斯鲁厄理工学院	卡尔斯鲁厄理工
卡尔斯鲁厄理工学院	kit
乌普萨拉大学	乌普萨拉
乌普萨拉大学	uppsala university
圣保罗大学	圣保罗
圣保罗大学	universidade de s?o paulo
伦敦大学玛丽女王学院	伦敦
伦敦大学玛丽女王学院	queen mary university of london
格罗宁根大学	格罗宁根
格罗宁根大学	university of groningen
柏林洪堡大学	柏林洪堡
柏林洪堡大学	humboldt-universit?t zu berlin
莱顿大学	莱顿
莱顿大学	leiden university
南京大学	nanjing university
乌得勒支大学	乌得勒支
乌得勒支大学	utrecht university
瓦格宁根大学	瓦格宁根
瓦格宁根大学	wageningen university
九州大学	九州
九州大学	kyushu university
马里兰大学学院公园分校	马里兰
马里兰大学学院公园分校	university of maryland
北海道大学	北海道
北海道大学	hokkaido university
查尔姆斯工业大学	查尔姆斯工业
查尔姆斯工业大学	chalmers university of technology
柏林自由大学	柏林自由
柏林自由大学	freie universitaet berlin
兰卡斯特大学	兰卡斯特
兰卡斯特大学	lancaster university
加州大学圣塔芭芭拉分校	加州
加州大学圣塔芭芭拉分校	university of california
智利天主大学	智利天主
智利天主大学	pontificia universidad católica de chile (uc)
约克大学（英国）	约克
约克大学（英国）	university of york
奥斯陆大学	奥斯陆
奥斯陆大学	university of oslo
匹兹堡大学	匹兹堡
匹兹堡大学	university of pittsburgh
法国中央理工学院	法国中央理工
法国中央理工学院	centralesupélec
根特大学	根特
根特大学	ghent university
伯尔尼大学	伯尔尼
伯尔尼大学	university of bern
阿尔托大学	阿尔托
阿尔托大学	aalto university
奥胡斯大学	奥胡斯
奥胡斯大学	aarhus university
密歇根州立大学	密歇根州立
密歇根州立大学	michigan state university
纽卡斯尔大学（英国）	纽卡斯尔
纽卡斯尔大学（英国）	newcastle university
亚琛工业大学	亚琛工业
亚琛工业大学	rwth aachen university
卡迪夫大学	卡迪夫
卡迪夫大学	cardiff university
麦克马斯特大学	麦克马斯特
麦克马斯特大学	mcmaster university
柏林工业大学	柏林工业
柏林工业大学	technische universit?t berlin (tu berlin)
艾茉莉大学	艾茉莉
艾茉莉大学	emory university
洛桑大学	洛桑
洛桑大学	university of lausanne
蒙特利尔大学	蒙特利尔
蒙特利尔大学	université de montréal
汉阳大学	hanyang university
利物浦大学	利物浦
利物浦大学	university of liverpool
埃克塞特大学	埃克塞特
埃克塞特大学	the university of exeter
耶路撒冷希伯来大学	耶路撒冷希伯来
耶路撒冷希伯来大学	the hebrew university of jerusalem
米兰理工大学	米兰理工
米兰理工大学	politecnico di milano
明尼苏达大学双城分校	明尼苏达
明尼苏达大学双城分校	university of minnesota
巴斯大学	巴斯
巴斯大学	university of bath
马德里自治大学	马德里自治
马德里自治大学	universidad autónoma de madrid
巴塞尔大学	巴塞尔
巴塞尔大学	university of basel
悉尼科技大学	悉尼科技
悉尼科技大学	university of technology sydney
印度理工学院孟买分校	印度理工
印度理工学院孟买分校	indian institute of technology bombay (iitb)
国立清华大学	国立清华
国立清华大学	national tsing hua university
滑铁卢大学	滑铁卢
滑铁卢大学	university of waterloo
鲁汶大学（法语）	鲁汶
鲁汶大学（法语）	université catholique de louvain (ucl)
巴塞罗那大学	巴塞罗那
巴塞罗那大学	universitat de barcelona
比萨圣安娜大学	比萨圣安娜
比萨圣安娜大学	scuola superiore sant'anna pisa di studi universitari e di perfezionamento
蒂宾根大学	蒂宾根
蒂宾根大学	eberhard karls universit?t tübingen
加州大学尔湾分校	加州
加州大学尔湾分校	university of california
印度科学学院	印度科学
印度科学学院	indian institute of science
卑尔根大学	卑尔根
卑尔根大学	university of bergen
阿伯丁大学	阿伯丁
阿伯丁大学	university of aberdeen
特文特大学	特文特
特文特大学	university of twente
印度理工学院德里分校	印度理工
印度理工学院德里分校	indian institute of technology delhi (iitd)
奥塔戈大学	奥塔戈
奥塔戈大学	university of otago
比萨高等师范学院	比萨高等师范
比萨高等师范学院	scuola normale superiore di pisa
维也纳大学	维也纳
维也纳大学	university of vienna
蒙特雷理工学院	蒙特雷理工
蒙特雷理工学院	instituto tecnológico y de estudios superiores de monterrey
伊拉斯姆斯大学	伊拉斯姆斯
伊拉斯姆斯大学	erasmus university rotterdam
贝尔法斯特女王大学	贝尔法斯特女王
贝尔法斯特女王大学	queen’s university belfast
博洛尼亚大学	博洛尼亚
博洛尼亚大学	alma mater studiorum - university of bologna
佛罗里达大学	佛罗里达
佛罗里达大学	university of florida
达特茅斯学院	达特茅斯
达特茅斯学院	dartmouth college
罗切斯特大学	罗切斯特
罗切斯特大学	university of rochester
马来西亚国民大学	马来西亚国民
马来西亚国民大学	universiti kebangsaan malaysia (ukm)
弗莱堡大学	弗莱堡
弗莱堡大学	albert-ludwigs-universitaet freiburg
凯斯西储大学	凯斯西储
凯斯西储大学	case western reserve university
布鲁塞尔自由大学（荷语）	布鲁塞尔自由
布鲁塞尔自由大学（荷语）	vrije universiteit brussel (vub)
法赫德国王石油与矿产大学	法赫德国王石油与矿产
法赫德国王石油与矿产大学	king fahd university of petroleum & minerals
科罗拉多大学博尔德分校	科罗拉多
科罗拉多大学博尔德分校	university of colorado boulder
德累斯顿工业大学	德累斯顿工业
德累斯顿工业大学	technische universit?t dresden
弗吉尼亚大学	弗吉尼亚
弗吉尼亚大学	university of virginia
巴塞罗那自治大学	巴塞罗那自治
巴塞罗那自治大学	universitat autònoma de barcelona
都柏林大学学院	都柏林
都柏林大学学院	university college dublin
范德堡大学	范德堡
范德堡大学	vanderbilt university
雷丁大学	雷丁
雷丁大学	university of reading
哥廷根大学	哥廷根
哥廷根大学	university of g?ttingen
庆应义塾大学	庆应义塾
庆应义塾大学	keio university
维也纳工业大学	维也纳工业
维也纳工业大学	vienna university of technology
开普敦大学	开普敦
开普敦大学	university of cape town
斯德哥尔摩大学	斯德哥尔摩
斯德哥尔摩大学	stockholm university
马来西亚博特拉大学	马来西亚博特拉
马来西亚博特拉大学	universiti putra malaysia (upm)
德州农工大学	德州农工
德州农工大学	texas a&m university
坎皮纳斯大学	坎皮纳斯
坎皮纳斯大学	universidade estadual de campinas (unicamp)
奈梅亨大学	奈梅亨
奈梅亨大学	radboud university
马德里康普斯顿大学	马德里康普斯顿
马德里康普斯顿大学	complutense university of madrid
马来西亚理科大学	马来西亚理科
马来西亚理科大学	universiti sains malaysia (usm)
国立交通大学	国立交通
国立交通大学	national chiao tung university
早稻田大学	早稻田
早稻田大学	waseda university
智利大学	智利
智利大学	universidad de chile
马斯特里赫特大学	马斯特里赫特
马斯特里赫特大学	maastricht university
圣母大学	圣母
圣母大学	university of notre dame
亚利桑那州立大学	亚利桑那州立
亚利桑那州立大学	arizona state university
纽卡斯尔大学（澳洲）	纽卡斯尔
纽卡斯尔大学（澳洲）	the university of newcastle
西安大略大学	西安大略
西安大略大学	the university of western ontario
伊利诺伊大学芝加哥分校	伊利诺伊
伊利诺伊大学芝加哥分校	university of illinois
罗马第一大学	罗马第一
罗马第一大学	sapienza university of rome
拉夫堡大学	拉夫堡
拉夫堡大学	loughborough university
卧龙岗大学	卧龙岗
卧龙岗大学	university of wollongong
国立哈萨克大学	国立哈萨克
国立哈萨克大学	al-farabi kazakh national university
巴黎政治学院	巴黎政治
巴黎政治学院	sciences po
惠灵顿维多利亚大学	惠灵顿维多利亚
惠灵顿维多利亚大学	victoria university of wellington
安特卫普大学	安特卫普
安特卫普大学	university of antwerp
汉堡大学	汉堡
汉堡大学	universit?t hamburg
莱斯特大学	莱斯特
莱斯特大学	university of leicester
乔治敦大学	乔治敦
乔治敦大学	georgetown university
萨塞克斯大学	萨塞克斯
萨塞克斯大学	university of sussex
马来西亚理工大学	马来西亚理工
马来西亚理工大学	universiti teknologi malaysia
卡尔加里大学	卡尔加里
卡尔加里大学	university of calgary
特拉维夫大学	特拉维夫
特拉维夫大学	tel aviv university
阿卜杜勒阿齐兹国王大学	阿卜杜勒阿齐兹国王
阿卜杜勒阿齐兹国王大学	king abdulaziz university (kau)
阿姆斯特丹自由大学	阿姆斯特丹自由
阿姆斯特丹自由大学	vrije universiteit amsterdam
坎特伯雷大学（新西兰）	坎特伯雷
坎特伯雷大学（新西兰）	university of canterbury
国立成功大学	国立成功
国立成功大学	national cheng kung university (ncku)
圣彼得堡国立大学	圣彼得堡国立
圣彼得堡国立大学	saint petersburg state university
伦敦大学皇家霍洛威学院	royal holloway university of london
贝鲁特美国大学	贝鲁特美国
贝鲁特美国大学	american university of beirut (aub)
塔夫斯大学	塔夫斯
塔夫斯大学	tufts university
巴黎第十一大学	巴黎第十一
巴黎第十一大学	université paris-sud
布鲁塞尔自由大学（法语）	布鲁塞尔自由
布鲁塞尔自由大学（法语）	universite libre de bruxelles
皇后大学	皇后
皇后大学	queen's university at kingston
迈阿密大学	迈阿密
迈阿密大学	university of miami
纳瓦拉大学	纳瓦拉
纳瓦拉大学	university of navarra
昆士兰科技大学	昆士兰科技
昆士兰科技大学	queensland university of technology (qut)
新西伯利亚国立大学	新西伯利亚国立
新西伯利亚国立大学	novosibirsk state university
亚利桑那大学	亚利桑那
亚利桑那大学	the university of arizona
以色列理工学院	以色列理工
以色列理工学院	technion - israel institute of technology
萨里大学	萨里
萨里大学	university of surrey
帕多瓦大学	帕多瓦
帕多瓦大学	università di padova
皇家墨尔本理工大学	皇家墨尔本理工
皇家墨尔本理工大学	rmit university
科廷大学	科廷
科廷大学	curtin university
麦考瑞大学	麦考瑞
麦考瑞大学	macquarie university
达姆施塔特工业大学	达姆施塔特工业
达姆施塔特工业大学	technische universit?t darmstadt
马德里卡洛斯三世大学	马德里卡洛斯三世
马德里卡洛斯三世大学	universidad carlos iii de madrid (uc3m)
波恩大学	波恩
波恩大学	rheinische friedrich-wilhelms-universit?t bonn
沙特国王大学	沙特国王
沙特国王大学	king saud university
国立台湾科技大学	国立台湾科技
国立台湾科技大学	national taiwan university of science and technology
武汉大学	wuhan university
马萨诸塞大学阿默斯特分校	马萨诸塞
马萨诸塞大学阿默斯特分校	university of massachusetts amherst
高威大学	高威
高威大学	national university of ireland galway
斯图加特大学	斯图加特
斯图加特大学	universit?t stuttgart
筑波大学	筑波
筑波大学	university of tsukuba
巴黎高等路桥学院	巴黎高等路桥
巴黎高等路桥学院	ecole des ponts paristech
南澳大学	南澳
南澳大学	university of south australia
庆熙大学	庆熙
庆熙大学	kyung hee university
西门菲莎大学	西门菲莎
西门菲莎大学	simon fraser university
印度理工学院马德拉斯分校	印度理工
印度理工学院马德拉斯分校	indian institute of technology madras (iitm)
斯凯莱德大学	斯凯莱德
斯凯莱德大学	university of strathclyde
东安格利亚大学	东安格利亚
东安格利亚大学	university of east anglia (uea)
哥德堡大学	哥德堡
哥德堡大学	university of gothenburg
朱拉隆功大学	朱拉隆功
朱拉隆功大学	chulalongkorn university
洛斯安第斯大学	洛斯安第斯
洛斯安第斯大学	universidad de los andes
怀卡托大学	怀卡托
怀卡托大学	university of waikato
哥伦比亚国立大学	哥伦比亚国立
哥伦比亚国立大学	universidad nacional de colombia
加泰罗尼亚理工大学	加泰罗尼亚理工
加泰罗尼亚理工大学	universitat politècnica de catalunya
托木斯克国立大学	托木斯克国立
托木斯克国立大学	tomsk state university
香港浸会大学	浸会
香港浸会大学	hong kong baptist university
北卡罗来纳州立大学	北卡罗来纳州立
北卡罗来纳州立大学	north carolina state university
戴尔豪斯大学	戴尔豪斯
戴尔豪斯大学	dalhousie university
法兰克福大学	法兰克福
法兰克福大学	universit?t frankfurt am main
因斯布鲁克大学	因斯布鲁克
因斯布鲁克大学	universit?t innsbruck
罗格斯大学	罗格斯
罗格斯大学	rutgers university - new brunswick
印度理工学院坎普尔分校	印度理工
印度理工学院坎普尔分校	indian institute of technology kanpur (iitk)
哈尔滨工业大学	哈尔滨工业
哈尔滨工业大学	harbin institute of technology
图库大学	图库
图库大学	university of turku
塔斯马尼亚大学	塔斯马尼亚
塔斯马尼亚大学	university of tasmania
伦敦大学亚非学院	soas university of london
格勒诺布尔大学	格勒诺布尔
格勒诺布尔大学	université grenoble-alpes
渥太华大学	渥太华
渥太华大学	university of ottawa
同济大学	同济
同济大学	tongji university
北京师范大学	北京师范
北京师范大学	beijing normal university
国立阳明大学	国立阳明
国立阳明大学	national yang ming university
印度尼西亚大学	印度尼西亚
印度尼西亚大学	universitas indonesia
巴黎第七大学	巴黎第七
巴黎第七大学	université diderotparis 7
印度理工学院克勒格布尔分校	印度理工
印度理工学院克勒格布尔分校	indian institute of technology kharagpur (iit-kgp)
中山大学	sun yat-sen university
庞培法布拉大学	庞培法布拉
庞培法布拉大学	universitat pompeu fabra
埃尔朗根-纽伦堡大学	埃尔朗根-纽伦堡
埃尔朗根-纽伦堡大学	friedrich-alexander-universit?t erlangen-nürnberg
巴黎第一大学	巴黎第一
巴黎第一大学	université paris 1 panthéon-sorbonne
鲍曼大学	鲍曼
鲍曼大学	bauman moscow state technical university
赫瑞瓦特大学	赫瑞瓦特
赫瑞瓦特大学	heriot-watt university
林雪平大学	林雪平
林雪平大学	link?ping university
夏威夷大学马诺阿分校	夏威夷
夏威夷大学马诺阿分校	university of hawai'i at ma?oa
卡尚高等师范学院	卡尚高等师范
卡尚高等师范学院	ecole normale supérieure de cachan
科隆大学	科隆
科隆大学	university of cologne
伦敦大学伯克贝克学院	伦敦
伦敦大学伯克贝克学院	birkbeck
国立台湾师范大学	国立台湾师范
国立台湾师范大学	national taiwan normal university
迪肯大学	迪肯
迪肯大学	deakin university
瓦伦西亚理工大学	瓦伦西亚理工
瓦伦西亚理工大学	universitat politècnica de valència
叶史瓦大学	叶史瓦
叶史瓦大学	the katz school at yeshiva university
莫斯科物理技术学院	莫斯科物理技术
莫斯科物理技术学院	moscow institute of?physics?and technology
纽约州立大学水牛城分校	纽约州立
纽约州立大学水牛城分校	university at buffalo suny
西安交通大学	西安交通
西安交通大学	xi’an jiaotong university
光州科技学院	光州科技
光州科技学院	gwangju institute of science and technology (gist)
哈里发大学	哈里发
哈里发大学	khalifa university
布拉格查尔斯大学	布拉格查尔斯
布拉格查尔斯大学	charles university
林肯大学	林肯
林肯大学	lincoln university
蒂尔堡大学	蒂尔堡
蒂尔堡大学	tilburg university
梨花女子大学	梨花女子
梨花女子大学	ewha womans university
广岛大学	广岛
广岛大学	hiroshima university
塔尔图大学	塔尔图
塔尔图大学	university of tartu
文莱达鲁萨兰大学	文莱达鲁萨兰
文莱达鲁萨兰大学	universiti brunei darussalam (ubd)
印第安纳大学伯明顿分校	印第安纳
印第安纳大学伯明顿分校	indiana university bloomington
米兰大学	米兰
米兰大学	university of milan
东北大学	northeastern university
耶拿大学	耶拿
耶拿大学	universit?t jena
波尔图大学	波尔图
波尔图大学	university of porto
格里菲斯大学	格里菲斯
格里菲斯大学	griffith university
明斯特大学	明斯特
明斯特大学	westf?lische wilhelms-universit?t münster
莫斯科核子研究大学	莫斯科核子研究
莫斯科核子研究大学	national research nuclear university mephi
布鲁内尔大学	布鲁内尔
布鲁内尔大学	brunel university london
卡塔尔大学	卡塔尔
卡塔尔大学	qatar university
梅西大学	梅西
梅西大学	massey university
乌尔姆大学	乌尔姆
乌尔姆大学	university ulm
加州大学圣克鲁兹分校	加州
加州大学圣克鲁兹分校	university of california
于韦斯屈莱大学	于韦斯屈莱
于韦斯屈莱大学	university of jyv?skyl?
弗吉尼亚理工学院	弗吉尼亚理工
弗吉尼亚理工学院	virginia polytechnic institute and state university
科克大学学院	科克
科克大学学院	university college cork
曼海姆大学	曼海姆
曼海姆大学	universit?t mannheim
南开大学	南开
南开大学	nankai university
于默奥大学	于默奥
于默奥大学	umea university
奥尔堡大学	奥尔堡
奥尔堡大学	aalborg university
俄罗斯国立高等经济学院	俄罗斯国立高等经济
俄罗斯国立高等经济学院	national research university higher school of economics
伦斯勒理工学院	伦斯勒理工
伦斯勒理工学院	rensselaer polytechnic institute
乔治华盛顿大学	乔治华盛顿
乔治华盛顿大学	george washington university
犹他大学	犹他
犹他大学	university of utah
斯特拉斯堡大学	斯特拉斯堡
斯特拉斯堡大学	université de strasbourg
纽约州立大学石溪分校	纽约州立
纽约州立大学石溪分校	stony brook university
阿联酋大学	阿联酋
阿联酋大学	united arab emirates university
伦敦城市大学	伦敦城市
东京医科齿科大学	东京医科齿科
东京医科齿科大学	tokyo medical and dental university (tmdu)
神户大学	神户
神户大学	kobe university
白俄罗斯国立大学	白俄罗斯国立
白俄罗斯国立大学	belarusian state university
埃塞克斯大学	埃塞克斯
埃塞克斯大学	university of essex
肯特大学	肯特
肯特大学	university of kent
里斯本大学	里斯本
里斯本大学	university of lisbon
莫斯科国立国际关系学院	莫斯科国立国际关系
莫斯科国立国际关系学院	moscow state institute of international relations
万隆理工学院	万隆理工
万隆理工学院	bandung institute of technology (itb)
维多利亚大学（加拿大）	维多利亚
维多利亚大学（加拿大）	university of victoria
里约热内卢联邦大学	里约热内卢联邦
里约热内卢联邦大学	universidade federal do rio de janeiro
台北医学大学	台北医学
台北医学大学	taipei medical university (tmu)
格拉茨工业大学	格拉茨工业
格拉茨工业大学	graz university of technology
牛津布鲁克斯大学	牛津布鲁克斯
牛津布鲁克斯大学	oxford brookes university
挪威科技大学	挪威科技
挪威科技大学	norwegian university of science and technology
坦佩雷理工大学	坦佩雷理工
坦佩雷理工大学	tampere university of technology
阿根廷奥斯特拉尔大学	阿根廷奥斯特拉尔
阿根廷奥斯特拉尔大学	universidad austral
堪萨斯大学	堪萨斯
堪萨斯大学	university of kansas
阿根廷天主大学	阿根廷天主
阿根廷天主大学	pontificia universidad católica argentina
特罗姆瑟大学	特罗姆瑟
特罗姆瑟大学	university of troms? the arctic university of norway
詹姆斯库克大学	詹姆斯库克
詹姆斯库克大学	james cook university
波鸿大学	波鸿
波鸿大学	ruhr-universit?t bochum
康涅狄格大学	康涅狄格
康涅狄格大学	university of connecticut
托木斯克理工大学	托木斯克理工
托木斯克理工大学	national research tomsk polytechnic university
圣加仑大学	圣加仑
圣加仑大学	university of st.gallen (hsg)
奥卢大学	奥卢
奥卢大学	university of oulu
波士顿学院	波士顿
波士顿学院	boston college
南丹麦大学	南丹麦
南丹麦大学	university of southern denmark
沙迦美国大学	沙迦美国
沙迦美国大学	american university of sharjah
玛希隆大学	玛希隆
玛希隆大学	mahidol university
阿斯顿大学	阿斯顿
阿斯顿大学	aston university
金山大学	金山
金山大学	university of witwatersrand
印度理工学院鲁尔基分校	印度理工
印度理工学院鲁尔基分校	indian institute of technology roorkee (iitr)
贝尔格拉诺大学	贝尔格拉诺
贝尔格拉诺大学	universidad de belgrano
菲律宾大学	菲律宾
菲律宾大学	university of the philippines
加州大学河滨分校	加州
加州大学河滨分校	university of california
都灵理工大学	都灵理工
都灵理工大学	politecnico di torino
韩国外国语大学	韩国外国语
韩国外国语大学	hufs - hankuk (korea) university of foreign studies
斯威本科技大学	斯威本科技
斯威本科技大学	swinburne university of technology
维克森林大学	维克森林
维克森林大学	wake forest university
华盛顿州立大学	华盛顿州立
华盛顿州立大学	washington state university
加札马达大学	加札马达
加札马达大学	gadjah mada university
列日大学	列日
列日大学	université de liège
国立欧亚大学	国立欧亚
国立欧亚大学	l.n. gumilyov eurasian national university (enu)
华沙大学	华沙
华沙大学	university of warsaw
伦敦大学金史密斯学院	伦敦
伦敦大学金史密斯学院	goldsmiths
巴基斯坦工程与应用科学学院	巴基斯坦工程与应用科学
巴基斯坦工程与应用科学学院	pakistan institute of engineering and applied sciences (pieas)
韩国中央大学	韩国中央
韩国中央大学	chung-ang university (cau)
康斯坦茨大学	康斯坦茨
康斯坦茨大学	universit?t konstanz
科罗拉多大学丹佛分校	科罗拉多
科罗拉多大学丹佛分校	university of colorado
拉筹伯大学	拉筹伯
拉筹伯大学	la trobe university
国立中山大学	国立中山
国立中山大学	national sun yat-sen university
拉瓦尔大学	拉瓦尔
拉瓦尔大学	laval university
圣彼得堡理工大学	圣彼得堡理工
圣彼得堡理工大学	peter the great saint-petersburg polytechnic university
斯泰伦博斯大学	斯泰伦博斯
斯泰伦博斯大学	stellenbosch university
新葡京大学	新葡京
新葡京大学	universidade nova de lisboa
本古里安大学	本古里安
本古里安大学	ben gurion university of the negev
哥伦比亚外事大学	哥伦比亚外事
哥伦比亚外事大学	universidad externado de colombia
科英布拉大学	科英布拉
科英布拉大学	university of coimbra
美因茨大学	美因茨
美因茨大学	johannes gutenberg universit?t mainz
雅盖隆大学	雅盖隆
雅盖隆大学	jagiellonian university
杜兰大学	杜兰
杜兰大学	tulane university
萨拉戈萨大学	萨拉戈萨
萨拉戈萨大学	universidad de zaragoza
乌拉尔联邦大学	乌拉尔联邦
乌拉尔联邦大学	ural federal university
国立中央大学	国立中央
国立中央大学	national central university
华中科技大学	华中科技
华中科技大学	huazhong university of science and technology
斯特林大学	斯特林
斯特林大学	university of stirling
伊斯兰堡国立科技大学	伊斯兰堡国立科技
伊斯兰堡国立科技大学	national university of sciences and technology (nust) islamabad
田纳西大学	田纳西
田纳西大学	the university of tennessee
巴勒莫大学	巴勒莫
巴勒莫大学	universidad de palermo (up)
开罗美国大学	开罗美国
开罗美国大学	the american university in cairo
比萨大学	比萨
比萨大学	university of pisa
都柏林城市大学	都柏林城市
都柏林城市大学	dublin city university
蒙彼利埃大学	蒙彼利埃
蒙彼利埃大学	université de montpellier
上海大学	shanghai university
德克萨斯大学达拉斯分校	德克萨斯
德克萨斯大学达拉斯分校	university of texas dallas
特伦托大学	特伦托
特伦托大学	university of trento
伊利诺伊理工学院	伊利诺伊理工
伊利诺伊理工学院	illinois institute of technology
布兰迪斯大学	布兰迪斯
布兰迪斯大学	brandeis university
长庚大学	长庚
长庚大学	chang gung university
佐治亚大学	佐治亚
佐治亚大学	the university of georgia
阿伯斯威大学	阿伯斯威
阿伯斯威大学	aberystwyth university
东国大学	东国
东国大学	dongguk university
沙里夫理工大学	沙里夫理工
沙里夫理工大学	sharif university of technology
爱荷华大学	爱荷华
爱荷华大学	university of iowa
班戈大学	班戈
班戈大学	bangor university
斯旺西大学	斯旺西
斯旺西大学	swansea university
西江大学	西江
西江大学	sogang university
喀山联邦大学	喀山联邦
喀山联邦大学	kazan (volga region) federal university
特拉华大学	特拉华
特拉华大学	university of delaware
韦恩州立大学	韦恩州立
韦恩州立大学	wayne state university
文莱工业大学	文莱工业
文莱工业大学	universiti teknologi brunei
澳门大学	university of macau
邦德大学	邦德
邦德大学	bond university
天津大学	tianjin university
俄罗斯友谊大学	俄罗斯友谊
俄罗斯友谊大学	rudn university
雅典国立科技大学	雅典国立科技
雅典国立科技大学	national technical university of athens
哈立德国王大学	哈立德国王
哈立德国王大学	king khalid university
科奇大学	科奇
科奇大学	koc university
俄勒冈州立大学	俄勒冈州立
俄勒冈州立大学	oregon state university
科罗拉多州立大学	科罗拉多州立
科罗拉多州立大学	colorado state university
苏丹卡布斯大学	苏丹卡布斯
苏丹卡布斯大学	sultan qaboos university
基尔大学（德国）	基尔
基尔大学（德国）	christian-albrechts-university zu kiel
马里兰大学巴尔的摩郡分校	马里兰
马里兰大学巴尔的摩郡分校	university of maryland
马赛大学	马赛
马赛大学	aix-marseille university
毕尔坎特大学	毕尔坎特
毕尔坎特大学	bilkent university
韩国天主大学	韩国天主
韩国天主大学	the catholic university of korea
林茨大学	林茨
林茨大学	johannes kepler university linz
一桥大学	一桥
一桥大学	hitotsubashi university
横滨市立大学	横滨市立
横滨市立大学	yokohama city university
克拉克大学	克拉克
克拉克大学	clark university
萨尔大学	萨尔
萨尔大学	universit?t des saarlandes
萨斯喀彻温大学	萨斯喀彻温
萨斯喀彻温大学	university of saskatchewan
奥克兰理工大学	奥克兰理工
奥克兰理工大学	auckland university of technology (aut)
北京理工大学	北京理工
北京理工大学	beijing institute of technology
哈萨克斯坦国立工业大学	哈萨克斯坦国立工业
哈萨克斯坦国立工业大学	kazakh national research technical university after k.i.satpayev
康考迪亚大学	康考迪亚
康考迪亚大学	concordia university
千叶大学	千叶
千叶大学	chiba university
圣保罗联邦大学	圣保罗联邦
圣保罗联邦大学	universidade federal de s?o paulo
马德里理工大学	马德里理工
马德里理工大学	universidad politécnica de madrid
塞格德大学	塞格德
塞格德大学	university of szeged
佛罗里达州立大学	佛罗里达州立
佛罗里达州立大学	florida state university
那不勒斯腓特烈二世大学	那不勒斯腓特烈二世
那不勒斯腓特烈二世大学	university of naples - federico ii
印度理工学院古瓦哈提分校	印度理工
印度理工学院古瓦哈提分校	indian institute of technology guwahati (iitg)
吉林大学	jilin university
俄罗斯国立科技大学	俄罗斯国立科技
俄罗斯国立科技大学	the national university of science and technology misis
厦门大学	xiamen university
佛林德斯大学	佛林德斯
佛林德斯大学	flinders university
里昂应用科学学院	里昂应用科学
里昂应用科学学院	institut national des sciences appliquées de lyon (insa)
南哈萨克斯坦州立大学	南哈萨克斯坦州立
南哈萨克斯坦州立大学	auezov south kazakhstan state university (sksu)
阿尔卡拉大学	阿尔卡拉
阿尔卡拉大学	universidad de alcalá
东芬兰大学	东芬兰
东芬兰大学	university of eastern finland
哈尔科夫国立大学	哈尔科夫国立
哈尔科夫国立大学	v. n. karazin kharkiv national university
哈萨克国立师范大学	哈萨克国立师范
哈萨克国立师范大学	abai kazakh national pedagogical university
思特雅大学	思特雅
思特雅大学	ucsi university
约克大学（加拿大）	约克
约克大学（加拿大）	york university
德里大学	德里
德里大学	university of delhi
维尔纽斯大学	维尔纽斯
维尔纽斯大学	vilnius university
爱荷华州立大学	爱荷华州立
爱荷华州立大学	iowa state university
波尔多大学	波尔多
波尔多大学	university of bordeaux
北京航空航天大学	北京航空航天
北京航空航天大学	beihang university (former buaa)
圣保罗州立大学	圣保罗州立
圣保罗州立大学	unesp
圣心天主大学	圣心天主
圣心天主大学	università cattolica del sacro cuore
新墨西哥大学	新墨西哥
新墨西哥大学	university of new mexico
俄克拉荷马大学	俄克拉荷马
俄克拉荷马大学	university of oklahoma
格拉纳达大学	格拉纳达
格拉纳达大学	university of granada
霍恩海姆大学	霍恩海姆
霍恩海姆大学	university of hohenheim
阿米喀布尔理工大学	阿米喀布尔理工
阿米喀布尔理工大学	amirkabir university of technology
北京科技大学	北京科技
北京科技大学	university of science and technology beijing
布伦瑞克工业大学	布伦瑞克工业
布伦瑞克工业大学	technische universit?t braunschweig
圣约瑟夫贝鲁特大学	圣约瑟夫贝鲁特
圣约瑟夫贝鲁特大学	saint joseph university of beirut (usj)
新加坡管理大学	新加坡管理
新加坡管理大学	singapore management university